year,st,firms,estabs,emp,denom,estabs_entry,estabs_entry_rate,estabs_exit,estabs_exit_rate,job_creation,job_creation_births,job_creation_continuers,job_creation_rate_births,job_creation_rate,job_destruction,job_destruction_deaths,job_destruction_continuers,job_destruction_rate_deaths,job_destruction_rate,net_job_creation,net_job_creation_rate,reallocation_rate,firmdeath_firms,firmdeath_estabs,firmdeath_emp
1978,01,54680,65572,1028244,988573,10267,15.995,7502,11.687,212385,70164,142221,7.098,21.484,133673,50823,82850,5.141,13.522,78712,7.962,27.044,5237,5313,27259
1978,02,7127,8438,107835,108129,1920,23.672,1266,15.608,35143,14262,20881,13.190,32.501,35629,17134,18495,15.846,32.951,-486,-0.449,65.002,827,833,8875
1978,04,40660,48980,705343,660831,9724,20.604,6153,13.038,192508,72870,119638,11.027,29.131,103188,43699,59489,6.613,15.615,89320,13.516,31.230,4302,4390,25580
1978,05,36580,41940,580104,556647,6971,16.996,5121,12.486,116283,41749,74534,7.500,20.890,69225,26098,43127,4.688,12.436,47058,8.454,24.872,3854,3877,17042
1978,06,388398,467513,7362671,7014974,82149,18.108,54446,12.001,1728546,600696,1127850,8.563,24.641,1034639,415795,618844,5.927,14.749,693907,9.892,29.498,37517,38051,219297
1978,08,56022,65359,926756,871474,12646,20.052,8060,12.780,234318,81144,153174,9.311,26.888,123401,51164,72237,5.871,14.160,110917,12.728,28.320,5720,5795,29025
1978,09,56335,64264,1177234,1148500,7846,12.418,5678,8.987,196123,51728,144395,4.504,17.076,139097,42965,96132,3.741,12.111,57026,4.965,24.222,3966,3996,20239
1978,10,9914,11486,219966,216448,1484,13.091,1184,10.445,36658,9581,27077,4.426,16.936,29063,8620,20443,3.982,13.427,7595,3.509,26.855,814,826,4768
1978,11,13401,15349,316839,305468,2040,13.398,1794,11.782,66220,17114,49106,5.603,21.678,44549,17157,27392,5.617,14.584,21671,7.094,29.168,1117,1140,5915
1978,12,165147,197194,2663064,2542079,35787,18.673,24710,12.893,648017,240630,407387,9.466,25.492,405242,173043,232199,6.807,15.941,242775,9.550,31.883,17695,17982,99862
1978,13,82160,100269,1643370,1572161,15721,15.994,11774,11.978,348448,119616,228832,7.608,22.164,205364,80455,124909,5.117,13.063,143084,9.101,26.125,8043,8134,43085
1978,15,15767,18947,281371,271252,3043,16.491,2053,11.126,61369,24687,36682,9.101,22.624,41008,17229,23779,6.352,15.118,20361,7.506,30.236,1319,1338,7107
1978,16,17468,20226,240115,229932,3684,18.836,2348,12.005,58713,22333,36380,9.713,25.535,38593,14327,24266,6.231,16.785,20120,8.750,33.569,1666,1683,7910
1978,17,179188,209775,4061446,3962548,26975,13.019,21814,10.528,704536,212012,492524,5.350,17.780,505506,186659,318847,4.711,12.757,199030,5.023,25.514,14962,15212,86719
1978,18,81468,98010,1792181,1739453,12767,13.224,9840,10.192,301607,89109,212498,5.123,17.339,196727,66600,130127,3.829,11.310,104880,6.029,22.619,6680,6769,34232
1978,19,55872,65423,876782,848116,8542,13.259,6549,10.165,160540,52921,107619,6.240,18.929,102902,37174,65728,4.383,12.133,57638,6.796,24.266,4690,4740,22734
1978,20,46140,53879,714537,693363,7427,14.014,5664,10.687,140255,48418,91837,6.983,20.228,98081,38266,59815,5.519,14.146,42174,6.083,28.291,4007,4049,21948
1978,21,51487,60277,921493,890181,8691,14.648,6802,11.464,181581,59760,121821,6.713,20.398,119577,44307,75270,4.977,13.433,62004,6.965,26.866,4774,4836,22041
1978,22,61238,72771,1174001,1108692,11081,15.554,8027,11.267,281181,88809,192372,8.010,25.362,149967,55213,94754,4.980,13.526,131214,11.835,27.053,5709,5772,28298
1978,23,19833,22647,314212,302288,3346,15.111,2337,10.554,58387,19197,39190,6.351,19.315,34367,12465,21902,4.124,11.369,24020,7.946,22.738,1651,1669,7000
1978,24,59514,70978,1193806,1157313,9373,13.405,7256,10.378,228262,70766,157496,6.115,19.723,155081,59369,95712,5.130,13.400,73181,6.323,26.800,4758,4854,27267
1978,25,96003,111288,2073579,1997318,13071,11.880,10545,9.584,386719,110494,276225,5.532,19.362,234182,94931,139251,4.753,11.725,152537,7.637,23.450,6986,7109,39604
1978,26,127352,152301,2960760,2845616,20481,13.671,15509,10.352,545085,159593,385492,5.608,19.155,315163,136780,178383,4.807,11.075,229922,8.080,22.151,10383,10568,60619
1978,27,67986,80067,1376603,1306488,11079,14.136,7691,9.813,290722,81768,208954,6.259,22.252,151107,59400,91707,4.547,11.566,139615,10.686,23.132,5318,5394,27548
1978,28,35908,42062,608707,585050,6456,15.616,5019,12.140,124524,43206,81318,7.385,21.284,76917,30675,46242,5.243,13.147,47607,8.137,26.294,3512,3536,17162
1978,29,81195,96461,1583659,1522460,13726,14.443,10875,11.443,314047,97184,216863,6.383,20.628,191455,72491,118964,4.761,12.575,122592,8.052,25.151,7434,7577,37417
1978,30,17389,19829,198307,186868,3377,17.506,2300,11.923,51199,16894,34305,9.041,27.399,28203,13364,14839,7.152,15.093,22996,12.306,30.185,1642,1648,7432
1978,31,31277,36112,459822,448665,4602,12.911,3668,10.290,84095,27528,56567,6.136,18.743,61652,23757,37895,5.295,13.741,22443,5.002,27.482,2636,2685,13786
1978,32,14693,16670,289041,265623,3510,22.028,2038,12.790,81731,28790,52941,10.839,30.770,35019,16549,18470,6.230,13.184,46712,17.586,26.367,1419,1432,10590
1978,33,17626,19679,294283,278074,3093,16.189,1946,10.186,63203,24824,38379,8.927,22.729,31145,11710,19435,4.211,11.200,32058,11.529,22.401,1394,1424,6753
1978,34,129443,147200,2435533,2375707,19079,13.132,15243,10.492,454891,136419,318472,5.742,19.148,334257,140389,193868,5.909,14.070,120634,5.078,28.140,10250,10345,66117
1978,35,22404,25960,312199,295369,4897,19.428,3389,13.445,82188,29625,52563,10.030,27.826,48848,22896,25952,7.752,16.538,33340,11.288,33.076,2449,2468,15266
1978,36,313829,354784,5622295,5522127,43378,12.282,40154,11.370,993881,291632,702249,5.281,17.998,790042,314715,475327,5.699,14.307,203839,3.691,28.614,28719,29049,149070
1978,37,88862,107473,1877946,1811297,15615,14.831,11236,10.672,333741,104180,229561,5.752,18.426,199789,71433,128356,3.944,11.030,133952,7.395,22.060,7755,7823,34988
1978,38,13253,15036,157288,150154,2051,13.898,1494,10.124,33026,10554,22472,7.029,21.995,18756,7429,11327,4.948,12.491,14270,9.504,24.982,1073,1081,4983
1978,39,155785,193682,3644556,3544248,23931,12.524,18732,9.803,629817,171614,458203,4.842,17.770,429331,151933,277398,4.287,12.113,200486,5.657,24.227,12243,12440,63593
1978,40,52011,60463,800001,765855,9936,16.751,7639,12.879,182150,69790,112360,9.113,23.784,114337,45766,68571,5.976,14.929,67813,8.855,29.859,5679,5731,28109
1978,41,50134,58004,797370,743002,10559,18.882,6391,11.429,200006,67115,132891,9.033,26.919,91678,38200,53478,5.141,12.339,108328,14.580,24.678,4677,4711,23842
1978,42,177755,212489,3872342,3798671,24971,11.873,20618,9.804,673621,201034,472587,5.292,17.733,529339,212807,316532,5.602,13.935,144282,3.798,27.870,13491,13730,108684
1978,44,18114,20109,326647,315442,2448,12.334,1925,9.699,61988,19359,42629,6.137,19.651,39618,17023,22595,5.397,12.560,22370,7.092,25.119,1371,1378,7956
1978,45,44597,52951,927955,893235,8137,15.735,5660,10.945,168463,56445,112018,6.319,18.860,99441,36798,62643,4.120,11.133,69022,7.727,22.265,3942,3989,16682
1978,46,14270,16019,171583,161844,2290,14.577,1671,10.637,38175,12857,25318,7.944,23.588,18688,7589,11099,4.689,11.547,19487,12.041,23.094,1179,1185,4617
1978,47,67822,80745,1386102,1333516,12033,15.160,9286,11.699,276422,88775,187647,6.657,20.729,170588,70694,99894,5.301,12.792,105834,7.936,25.585,6432,6487,33127
1978,48,226949,278634,4427639,4209840,48499,17.891,33395,12.319,1073897,389811,684086,9.260,25.509,639871,261316,378555,6.207,15.199,434026,10.310,30.399,23333,23680,145237
1978,49,23313,26937,399727,374258,5022,19.346,3066,11.811,106034,40415,65619,10.799,28.332,55706,21508,34198,5.747,14.884,50328,13.447,29.769,2177,2209,12043
1978,50,10924,12110,158542,152111,1880,16.016,1137,9.686,33700,10760,22940,7.074,22.155,21298,10845,10453,7.130,14.002,12402,8.153,28.003,843,851,7973
1978,51,76561,92935,1500787,1445869,13601,14.963,9532,10.486,304422,98627,205795,6.821,21.055,195204,75296,119908,5.208,13.501,109218,7.554,27.002,6309,6404,34752
1978,53,71790,84155,1148722,1083009,15036,18.540,8924,11.004,275555,85670,189885,7.910,25.443,143348,57417,85931,5.302,13.236,132207,12.207,26.472,6266,6338,32978
1978,54,26630,31049,459189,456763,4099,13.325,3524,11.456,75693,24645,51048,5.396,16.572,70442,20893,49549,4.574,15.422,5251,1.150,30.844,2340,2364,10455
1978,55,79045,91352,1550824,1491104,11927,13.335,8109,9.066,271032,76694,194338,5.143,18.177,152152,55724,96428,3.737,10.204,118880,7.973,20.408,5639,5687,30469
1978,56,10475,11699,131779,120652,2308,20.530,1394,12.400,41753,15519,26234,12.863,34.606,19337,8170,11167,6.772,16.027,22416,18.579,32.054,979,991,4533
1979,01,56228,67501,1088895,1060190,9483,14.238,7685,11.539,215875,68297,147578,6.442,20.362,158362,54363,103999,5.128,14.937,57513,5.425,29.874,5572,5633,31577
1979,02,7330,8638,109325,108696,1651,19.318,1468,17.177,27226,10117,17109,9.308,25.048,26129,9428,16701,8.674,24.039,1097,1.009,48.077,950,960,5452
1979,04,42672,51555,797124,752677,9015,17.911,6567,13.048,194973,67584,127389,8.979,25.904,106488,41155,65333,5.468,14.148,88485,11.756,28.296,4756,4853,26550
1979,05,37386,42835,604694,592276,6192,14.609,5293,12.488,106054,36091,69963,6.094,17.906,80932,27118,53814,4.579,13.665,25122,4.242,27.329,3965,4002,18514
1979,06,411751,494207,8055808,7721634,81147,16.851,55858,11.599,1764445,582416,1182029,7.543,22.851,1097077,402694,694383,5.215,14.208,667368,8.643,28.416,38666,39148,216383
1979,08,58728,68332,1024746,978389,11656,17.414,8861,13.238,230939,80872,150067,8.266,23.604,138009,53965,84044,5.516,14.106,92930,9.498,28.211,6357,6431,33014
1979,09,58441,66553,1257041,1217784,7652,11.686,5504,8.406,200468,58269,142199,4.785,16.462,121736,42850,78886,3.519,9.997,78732,6.465,19.993,3754,3773,20742
1979,10,10315,11933,229056,224764,1533,13.076,1115,9.510,32761,10668,22093,4.746,14.576,24148,7581,16567,3.373,10.744,8613,3.832,21.487,747,764,3533
1979,11,13699,15681,340080,328959,1948,12.536,1665,10.715,56718,13368,43350,4.064,17.242,34624,12521,22103,3.806,10.525,22094,6.716,21.051,1136,1152,6705
1979,12,175106,208860,2892892,2782010,35596,17.514,24357,11.984,646628,240903,405725,8.659,23.243,423674,171379,252295,6.160,15.229,222954,8.014,30.458,17519,17727,107726
1979,13,84883,104003,1722024,1685973,15141,14.809,11623,11.368,308430,108555,199875,6.439,18.294,236962,79574,157388,4.720,14.055,71468,4.239,28.110,8197,8282,44096
1979,15,16762,20212,303881,293898,3149,16.049,1967,10.025,57728,20623,37105,7.017,19.642,37726,12922,24804,4.397,12.836,20002,6.806,25.673,1354,1374,8077
1979,16,17785,20638,247294,244445,3132,15.315,2756,13.477,48629,18200,30429,7.445,19.894,43126,15692,27434,6.419,17.642,5503,2.251,35.285,2061,2073,9652
1979,17,182534,213831,4242270,4160848,25206,11.886,21662,10.215,706669,212428,494241,5.105,16.984,539918,175870,364048,4.227,12.976,166751,4.008,25.952,14840,15089,81991
1979,18,83761,100890,1899685,1852793,11937,11.985,9351,9.389,291225,83775,207450,4.522,15.718,197716,64860,132856,3.501,10.671,93509,5.047,21.342,6726,6811,35650
1979,19,56781,66573,916837,898058,7707,11.662,6734,10.190,147559,47586,99973,5.299,16.431,110026,38349,71677,4.270,12.252,37533,4.179,24.503,4938,4990,24179
1979,20,47453,55404,764404,740531,7035,12.858,5652,10.330,139232,44358,94874,5.990,18.802,90786,33126,57660,4.473,12.260,48446,6.542,24.519,4038,4085,19895
1979,21,53174,62427,980895,954840,8408,13.686,6420,10.450,174772,59402,115370,6.221,18.304,123085,40545,82540,4.246,12.891,51687,5.413,25.781,4641,4672,21962
1979,22,64268,76337,1247949,1206043,11485,15.400,7963,10.678,261491,88666,172825,7.352,21.682,177780,62814,114966,5.208,14.741,83711,6.941,29.482,5806,5866,36566
1979,23,20418,23353,321433,314198,3013,13.085,2358,10.241,52069,17193,34876,5.472,16.572,37796,11995,25801,3.818,12.029,14273,4.543,24.059,1716,1724,6752
1979,24,61656,73647,1266495,1232537,9414,13.000,6949,9.596,222237,66407,155830,5.388,18.031,154207,53420,100787,4.334,12.511,68030,5.520,25.023,4781,4843,25265
1979,25,98318,114014,2218527,2149582,12647,11.213,10194,9.038,375596,105575,270021,4.911,17.473,239004,75796,163208,3.526,11.119,136592,6.354,22.237,6879,6966,39243
1979,26,131082,156702,3115852,3033163,18755,12.123,14759,9.540,502027,137475,364552,4.532,16.551,335396,101436,233960,3.344,11.058,166631,5.494,22.115,10324,10486,56538
1979,27,70716,83222,1475450,1430989,10476,12.808,7622,9.318,265886,80494,185392,5.625,18.581,177301,54427,122874,3.803,12.390,88585,6.190,24.780,5410,5459,29257
1979,28,37112,43502,630665,620439,6151,14.362,4806,11.221,110407,38123,72284,6.145,17.795,89087,30735,58352,4.954,14.359,21320,3.436,28.717,3441,3470,17574
1979,29,83817,99417,1664419,1627235,13013,13.268,10340,10.542,275315,83306,192009,5.119,16.919,200994,68173,132821,4.189,12.352,74321,4.567,24.704,7339,7427,37809
1979,30,17972,20477,213306,206415,3168,15.701,2568,12.727,45210,17343,27867,8.402,21.902,31580,12165,19415,5.893,15.299,13630,6.603,30.599,1890,1901,8666
1979,31,32342,37231,489703,476009,4429,12.059,3421,9.315,83603,23061,60542,4.845,17.563,55988,19090,36898,4.010,11.762,27615,5.801,23.524,2459,2478,12348
1979,32,15730,17955,335212,314505,3593,20.728,2351,13.563,88453,33103,55350,10.525,28.125,47612,20569,27043,6.540,15.139,40841,12.986,30.277,1691,1700,12400
1979,33,18429,20618,321337,308387,2878,14.265,1992,9.874,60232,17421,42811,5.649,19.531,34456,12669,21787,4.108,11.173,25776,8.358,22.346,1445,1455,6919
1979,34,134106,152338,2572143,2504583,18958,12.643,14189,9.462,452124,133336,318788,5.324,18.052,317176,103509,213667,4.133,12.664,134948,5.388,25.328,9675,9721,47901
1979,35,23064,26767,337487,326077,4308,16.319,3572,13.531,75348,27554,47794,8.450,23.107,52619,21198,31421,6.501,16.137,22729,6.970,32.274,2514,2543,13020
1979,36,318651,360135,5923136,5792893,41589,11.621,37062,10.356,983455,275647,707808,4.758,16.977,721958,247893,474065,4.279,12.463,261497,4.514,24.926,26864,27145,127864
1979,37,92374,111863,2000406,1946883,14790,13.470,10668,9.716,318024,102284,215740,5.254,16.335,210861,69509,141352,3.570,10.831,107163,5.504,21.661,7730,7818,40777
1979,38,13905,15736,170946,164706,2202,14.295,1538,9.984,34463,13503,20960,8.198,20.924,22002,8329,13673,5.057,13.358,12461,7.566,26.717,1101,1105,5593
1979,39,159909,198775,3817107,3736671,22733,11.571,18128,9.227,587303,174452,412851,4.669,15.717,427458,137390,290068,3.677,11.440,159845,4.278,22.879,12085,12311,64602
1979,40,53946,62897,858651,828421,9927,16.096,7480,12.128,181226,66021,115205,7.969,21.876,120071,46397,73674,5.601,14.494,61155,7.382,28.988,5595,5638,29533
1979,41,52455,60678,840331,820489,9754,16.416,7232,12.172,165215,58398,106817,7.117,20.136,125462,46527,78935,5.671,15.291,39753,4.845,30.582,5163,5221,26813
1979,42,182569,218378,4045214,3963702,24000,11.125,18710,8.673,623653,172564,451089,4.354,15.734,461069,146016,315053,3.684,11.632,162584,4.102,23.265,13103,13280,67206
1979,44,18711,20755,344335,336132,2362,11.548,1760,8.605,56871,17242,39629,5.130,16.919,40258,12945,27313,3.851,11.977,16613,4.942,23.954,1253,1267,6862
1979,45,45816,54583,973527,954286,7301,13.563,5795,10.765,149920,45317,104603,4.749,15.710,111607,34159,77448,3.580,11.695,38313,4.015,23.391,4170,4235,20034
1979,46,14852,16712,182005,177238,2236,13.641,1595,9.731,33559,13059,20500,7.368,18.934,24054,8501,15553,4.796,13.572,9505,5.363,27.143,1175,1177,5351
1979,47,69909,83450,1458438,1426967,11716,14.252,9228,11.225,247565,80626,166939,5.650,17.349,184598,64488,120110,4.519,12.936,62967,4.413,25.873,6600,6649,35896
1979,48,237623,292195,4717112,4565802,47394,16.599,34050,11.925,1026616,373928,652688,8.190,22.485,724762,267566,457196,5.860,15.874,301854,6.611,31.747,24893,25213,166446
1979,49,23934,27736,429437,415287,4422,16.154,3697,13.506,94371,34157,60214,8.225,22.724,66430,24870,41560,5.989,15.996,27941,6.728,31.992,2694,2755,14697
1979,50,11393,12640,166284,162395,1735,14.008,1226,9.899,27513,9459,18054,5.825,16.942,19917,6807,13110,4.192,12.265,7596,4.677,24.529,934,937,4578
1979,51,79696,96811,1599988,1552367,12959,13.640,9354,9.845,290935,91492,199443,5.894,18.741,194938,62351,132587,4.017,12.557,95997,6.184,25.115,6634,6701,32606
1979,53,75702,88484,1230639,1180002,14008,16.202,9956,11.515,272650,86462,186188,7.327,23.106,170389,61405,108984,5.204,14.440,102261,8.666,28.879,6959,7052,35170
1979,54,27676,32220,500611,479608,4483,14.156,3381,10.676,97439,24720,72719,5.154,20.316,55648,19049,36599,3.972,11.603,41791,8.714,23.206,2347,2369,10216
1979,55,81741,94547,1625121,1589416,10810,11.614,7878,8.464,243087,70154,172933,4.414,15.294,171568,53495,118073,3.366,10.794,71519,4.500,21.589,5552,5602,26346
1979,56,11018,12349,144211,138374,2118,17.583,1511,12.544,35302,13581,21721,9.815,25.512,23774,8314,15460,6.008,17.181,11528,8.331,34.362,1099,1105,5786
1980,01,55902,67287,1082002,1085259,8517,12.638,8731,12.955,168599,53965,114634,4.973,15.535,174977,55213,119764,5.088,16.123,-6378,-0.588,31.071,6318,6381,33448
1980,02,7327,8649,106933,108131,1448,16.755,1434,16.593,23309,8929,14380,8.258,21.556,25742,9712,16030,8.982,23.806,-2433,-2.250,43.113,966,977,4669
1980,04,44624,53951,821557,810013,9092,17.232,6712,12.722,163757,62804,100953,7.753,20.217,140760,48074,92686,5.935,17.377,22997,2.839,34.755,4791,4858,26146
1980,05,37412,42910,606620,606479,5542,12.925,5479,12.778,95475,31490,63985,5.192,15.743,95073,29762,65311,4.907,15.676,402,0.066,31.352,4107,4160,17426
1980,06,424709,509799,8261429,8158868,78205,15.580,62527,12.457,1569429,579381,990048,7.101,19.236,1364214,459086,905128,5.627,16.721,205215,2.515,33.441,44264,44859,251475
1980,08,60585,70462,1057940,1042232,11421,16.458,9286,13.381,205348,74743,130605,7.171,19.703,174094,66207,107887,6.352,16.704,31254,2.999,33.408,6737,6833,39740
1980,09,59285,67653,1289363,1274435,7351,10.952,6289,9.370,179218,54553,124665,4.281,14.063,149268,47336,101932,3.714,11.712,29950,2.350,23.425,4471,4525,21020
1980,10,10353,11948,236826,233435,1309,10.965,1288,10.790,32530,9952,22578,4.263,13.935,25926,7307,18619,3.130,11.106,6604,2.829,22.213,927,953,3843
1980,11,13733,15704,336621,339172,1903,12.158,1800,11.500,56994,17529,39465,5.168,16.804,60827,29386,31441,8.664,17.934,-3833,-1.130,33.608,1234,1252,7582
1980,12,183784,218786,3017020,2954805,36071,16.866,26239,12.269,599606,232526,367080,7.869,20.293,475954,173637,302317,5.876,16.108,123652,4.185,32.216,19416,19663,110138
1980,13,85940,105459,1739664,1732592,13936,13.305,12510,11.943,269318,98218,171100,5.669,15.544,254685,83767,170918,4.835,14.700,14633,0.845,29.399,8864,8968,46441
1980,15,17605,21187,313419,308926,3124,15.097,2136,10.322,53986,21641,32345,7.005,17.475,45191,14565,30626,4.715,14.628,8795,2.847,29.257,1502,1530,8560
1980,16,17844,20736,246230,246637,2965,14.330,2875,13.895,43553,17131,26422,6.946,17.659,43792,15412,28380,6.249,17.756,-239,-0.097,35.318,2109,2134,9847
1980,17,182852,214677,4162987,4201553,24008,11.203,23269,10.858,547575,190282,357293,4.529,13.033,626960,173962,452998,4.140,14.922,-79385,-1.889,26.065,16502,16708,88206
1980,18,83694,101162,1815558,1856509,10938,10.825,10706,10.595,215456,77210,138246,4.159,11.605,297632,69682,227950,3.753,16.032,-82176,-4.426,23.211,7639,7731,35327
1980,19,56682,66755,902059,907914,7140,10.707,7004,10.503,119160,40937,78223,4.509,13.125,131055,38422,92633,4.232,14.435,-11895,-1.310,26.249,5292,5325,23950
1980,20,47691,55719,772908,768843,6354,11.433,6066,10.915,118544,40591,77953,5.279,15.419,110644,31911,78733,4.151,14.391,7900,1.028,28.782,4474,4517,20573
1980,21,52898,62433,955634,966953,7200,11.534,7185,11.510,129915,47206,82709,4.882,13.436,152594,40752,111842,4.214,15.781,-22679,-2.345,26.871,5344,5387,25502
1980,22,65187,77580,1260953,1253360,10386,13.501,9084,11.808,220427,71361,149066,5.694,17.587,204435,62061,142374,4.952,16.311,15992,1.276,32.622,6671,6729,37355
1980,23,20343,23345,322553,321736,2685,11.495,2711,11.606,45448,14140,31308,4.395,14.126,43930,15193,28737,4.722,13.654,1518,0.472,27.308,1928,1946,8698
1980,24,62605,74857,1296276,1281744,8887,11.968,7691,10.357,214457,67651,146806,5.278,16.732,185601,52099,133502,4.065,14.480,28856,2.251,28.961,5304,5370,28255
1980,25,99436,115446,2271571,2244816,12079,10.525,10712,9.334,338723,95990,242733,4.276,15.089,285410,86780,198630,3.866,12.714,53313,2.375,25.428,7393,7493,39965
1980,26,130959,157433,2910795,3012541,17515,11.148,16871,10.738,353488,124093,229395,4.119,11.734,559814,121811,438003,4.043,18.583,-206326,-6.849,23.468,11934,12077,67121
1980,27,71638,84438,1487986,1481504,9422,11.234,8293,9.888,222623,70876,151747,4.784,15.027,210183,62227,147956,4.200,14.187,12440,0.840,28.374,5998,6086,34820
1980,28,37475,44042,620772,625868,5717,13.059,5189,11.853,93282,34366,58916,5.491,14.904,103169,30775,72394,4.917,16.484,-9887,-1.580,29.809,3819,3848,18243
1980,29,83773,99522,1644878,1655193,11493,11.553,11410,11.470,229074,78468,150606,4.741,13.840,249627,73944,175683,4.467,15.081,-20553,-1.242,27.679,8222,8317,38600
1980,30,17985,20486,208751,211068,2697,13.167,2692,13.142,36637,14727,21910,6.977,17.358,41250,13292,27958,6.297,19.543,-4613,-2.186,34.716,1921,1931,8919
1980,31,32349,37334,486149,487873,4100,10.996,4007,10.746,70813,25182,45631,5.162,14.515,74664,20568,54096,4.216,15.304,-3851,-0.789,29.029,2983,3015,12915
1980,32,16361,18757,345129,339985,3393,18.476,2608,14.201,68643,29181,39462,8.583,20.190,57967,20373,37594,5.992,17.050,10676,3.140,34.100,1907,1933,11778
1980,33,18525,20779,328230,325008,2481,11.983,2333,11.268,52688,17663,35025,5.435,16.211,46566,16441,30125,5.059,14.328,6122,1.884,28.655,1674,1687,9513
1980,34,136249,154898,2598995,2588598,17798,11.582,15344,9.985,389091,123982,265109,4.790,15.031,368140,106874,261266,4.129,14.222,20951,0.809,28.443,11059,11119,55150
1980,35,23254,27024,335534,336233,4019,14.941,3770,14.015,63011,25640,37371,7.626,18.740,64711,23199,41512,6.900,19.246,-1700,-0.506,37.481,2671,2693,14334
1980,36,319242,360922,5939404,5917488,39470,10.945,38861,10.776,870635,263676,606959,4.456,14.713,828506,262458,566048,4.435,14.001,42129,0.712,28.002,28729,28966,146252
1980,37,92914,112925,2002435,1997447,13477,11.989,12446,11.072,267228,89778,177450,4.495,13.378,255693,77035,178658,3.857,12.801,11535,0.577,25.602,9012,9124,43078
1980,38,14029,15950,174162,172574,1952,12.317,1749,11.036,29958,11025,18933,6.389,17.360,26837,8611,18226,4.990,15.551,3121,1.808,31.102,1296,1302,5587
1980,39,159944,199403,3741123,3779861,20283,10.186,19743,9.914,477386,150669,326717,3.986,12.630,554896,141907,412989,3.754,14.680,-77510,-2.051,25.259,13633,13823,68698
1980,40,54901,64091,886961,871788,9370,14.764,8120,12.794,173609,68323,105286,7.837,19.914,142065,49998,92067,5.735,16.296,31544,3.618,32.592,6008,6073,32007
1980,41,53427,61962,848393,845062,9549,15.571,8277,13.497,152537,60215,92322,7.126,18.050,146488,50406,96082,5.965,17.335,6049,0.716,34.669,6084,6201,31656
1980,42,181884,218270,4060494,4057504,21314,9.760,21526,9.857,534727,169833,364894,4.186,13.179,527093,156536,370557,3.858,12.991,7634,0.188,25.981,15287,15469,80232
1980,44,18766,20799,342233,343205,2119,10.200,2071,9.969,45121,12965,32156,3.778,13.147,47241,11886,35355,3.463,13.765,-2120,-0.618,26.294,1502,1512,6391
1980,45,46271,55305,959563,952166,7098,12.917,6387,11.623,136859,45894,90965,4.820,14.373,122067,36678,85389,3.852,12.820,14792,1.554,25.640,4573,4656,19728
1980,46,14908,16807,181663,181736,1910,11.391,1830,10.914,29129,11207,17922,6.167,16.028,29437,9456,19981,5.203,16.198,-308,-0.169,32.056,1352,1359,5671
1980,47,70173,84032,1439425,1448601,10579,12.632,10011,11.954,203994,70786,133208,4.887,14.082,222195,67536,154659,4.662,15.339,-18201,-1.256,28.164,7321,7402,38325
1980,48,244371,301390,4893194,4804407,46354,15.623,36964,12.459,971533,352627,618906,7.340,20.222,790917,262331,528586,5.460,16.462,180616,3.759,32.925,26366,26769,151982
1980,49,23890,27845,436649,433004,4124,14.841,4011,14.434,78406,29730,48676,6.866,18.107,71111,27208,43903,6.284,16.423,7295,1.685,32.845,2894,2930,16244
1980,50,11570,12853,166985,166660,1576,12.362,1368,10.730,24339,7416,16923,4.450,14.604,23517,6555,16962,3.933,14.111,822,0.493,28.222,1051,1057,4072
1980,51,80524,98104,1630956,1615724,11966,12.279,10664,10.943,247965,80632,167333,4.990,15.347,217322,64081,153241,3.966,13.450,30643,1.897,26.901,7617,7702,34931
1980,53,76491,89781,1267028,1247728,13106,14.707,11778,13.216,243209,85433,157776,6.847,19.492,205683,70288,135395,5.633,16.485,37526,3.008,32.969,8454,8554,45879
1980,54,27525,32164,484991,492765,3729,11.584,3781,11.746,66688,23946,42742,4.860,13.533,81937,22773,59164,4.621,16.628,-15249,-3.095,27.067,2766,2775,11816
1980,55,81920,94994,1615656,1620379,9573,10.099,9162,9.666,200269,60882,139387,3.757,12.359,210757,57025,153732,3.519,13.007,-10488,-0.647,24.719,6663,6737,32130
1980,56,11353,12769,151340,147837,2005,15.959,1594,12.688,32647,12087,20560,8.176,22.083,25699,9044,16655,6.118,17.383,6948,4.700,34.767,1142,1160,6395
1981,01,55370,67099,1070067,1074198,8309,12.367,8490,12.636,167433,65887,101546,6.134,15.587,176020,51908,124112,4.832,16.386,-8587,-0.799,31.174,6269,6358,32188
1981,02,7677,9047,119544,113194,1648,18.632,1244,14.064,32893,12106,20787,10.695,29.059,19995,7320,12675,6.467,17.664,12898,11.395,35.329,814,819,4037
1981,04,46265,56249,845184,832792,9463,17.181,7119,12.926,161214,67099,94115,8.057,19.358,136322,42870,93452,5.148,16.369,24892,2.989,32.739,5222,5304,28043
1981,05,37051,42812,602283,603569,5441,12.703,5480,12.794,89612,36618,52994,6.067,14.847,92631,27596,65035,4.572,15.347,-3019,-0.500,29.694,4076,4117,18657
1981,06,433401,521994,8445877,8357041,78300,15.181,65847,12.767,1581027,603677,977350,7.224,18.919,1400776,462721,938055,5.537,16.762,180251,2.157,33.523,46806,47540,267206
1981,08,61978,72534,1093310,1075984,11787,16.494,9641,13.491,224003,89590,134413,8.326,20.818,189086,68083,121003,6.328,17.573,34917,3.245,35.147,7192,7273,44707
1981,09,59775,68381,1300288,1294127,7368,10.836,6602,9.709,176939,66585,110354,5.145,13.672,164705,53260,111445,4.116,12.727,12234,0.945,25.454,4661,4715,22425
1981,10,10352,11997,238514,236256,1319,11.020,1263,10.552,32098,11927,20171,5.048,13.586,27402,8661,18741,3.666,11.598,4696,1.988,23.197,888,903,3960
1981,11,13743,15727,343652,340150,1909,12.136,1916,12.180,54185,19734,34451,5.802,15.930,47410,16637,30773,4.891,13.938,6775,1.992,27.876,1331,1344,7901
1981,12,191886,229411,3181879,3099916,38269,17.083,27482,12.268,658791,272122,386669,8.778,21.252,494379,163218,331161,5.265,15.948,164412,5.304,31.896,20772,21012,107261
1981,13,86874,107268,1786578,1762518,14532,13.668,12642,11.890,307304,121089,186215,6.870,17.436,259168,81253,177915,4.610,14.704,48136,2.731,29.409,9069,9210,46044
1981,15,18082,21797,321655,317220,3103,14.444,2475,11.521,57147,23771,33376,7.494,18.015,48190,15202,32988,4.792,15.191,8957,2.824,30.383,1810,1856,9844
1981,16,17626,20603,244604,245508,2759,13.349,2890,13.983,41001,16882,24119,6.876,16.701,42913,15349,27564,6.252,17.479,-1912,-0.779,33.401,2133,2167,10083
1981,17,182492,215172,4094496,4130401,23779,11.067,23159,10.779,551238,204209,347029,4.944,13.346,623217,167412,455805,4.053,15.089,-71979,-1.743,26.692,16687,16944,96640
1981,18,82925,100794,1781470,1798151,10388,10.290,10703,10.602,219179,75556,143623,4.202,12.189,253073,68854,184219,3.829,14.074,-33894,-1.885,24.378,7717,7843,37939
1981,19,56389,66733,883679,892772,6888,10.324,6856,10.276,123406,61188,62218,6.854,13.823,141531,48429,93102,5.425,15.853,-18125,-2.030,27.646,5245,5330,23020
1981,20,47857,56159,786660,780032,6683,11.952,6198,11.084,128141,47102,81039,6.038,16.428,116365,35062,81303,4.495,14.918,11776,1.510,29.836,4551,4616,21382
1981,21,52619,62334,956094,959241,7121,11.419,7180,11.513,137779,51734,86045,5.393,14.363,144183,42689,101494,4.450,15.031,-6404,-0.668,28.727,5290,5339,25571
1981,22,66794,79732,1327267,1293563,11180,14.222,8939,11.371,256204,90614,165590,7.005,19.806,187876,63415,124461,4.902,14.524,68328,5.282,29.048,6552,6640,35769
1981,23,20239,23330,323569,323142,2629,11.270,2622,11.240,45200,15041,30159,4.655,13.988,44142,14392,29750,4.454,13.660,1058,0.327,27.320,1934,1948,7938
1981,24,63193,76084,1311520,1304645,9049,11.994,7768,10.296,203146,74716,128430,5.727,15.571,189525,54294,135231,4.162,14.527,13621,1.044,29.054,5408,5503,30812
1981,25,100388,117108,2326563,2305578,12379,10.650,10638,9.152,361339,124569,236770,5.403,15.672,318142,106740,211402,4.630,13.799,43197,1.874,27.598,7336,7472,55090
1981,26,129729,156719,2833426,2873606,17008,10.831,17622,11.222,380865,137845,243020,4.797,13.254,461036,129453,331583,4.505,16.044,-80171,-2.790,26.508,12125,12359,64032
1981,27,71769,84964,1473964,1479861,9292,10.976,8673,10.245,213255,76544,136711,5.172,14.410,225412,66809,158603,4.515,15.232,-12157,-0.821,28.821,6047,6154,36396
1981,28,37112,43934,620648,621430,5247,11.930,5339,12.140,90234,32282,57952,5.195,14.520,91700,25835,65865,4.157,14.756,-1466,-0.236,29.041,4079,4128,18277
1981,29,83619,99780,1635363,1638914,11636,11.682,11288,11.333,237113,93770,143343,5.721,14.468,244379,77238,167141,4.713,14.911,-7266,-0.443,28.935,8192,8308,41204
1981,30,18123,20650,208873,208764,2745,13.347,2577,12.530,37943,14359,23584,6.878,18.175,38033,13346,24687,6.393,18.218,-90,-0.043,36.350,1877,1895,8317
1981,31,32378,37468,493193,489298,3996,10.685,3856,10.311,76620,25540,51080,5.220,15.659,69424,22170,47254,4.531,14.189,7196,1.471,28.377,2825,2860,13774
1981,32,16899,19493,352483,348736,3444,18.020,2683,14.038,72543,31461,41082,9.021,20.802,64561,22567,41994,6.471,18.513,7982,2.289,37.026,1991,2021,16512
1981,33,18762,21132,334215,331600,2638,12.592,2274,10.854,51503,18792,32711,5.667,15.532,46508,11892,34616,3.586,14.025,4995,1.506,28.051,1670,1707,7769
1981,34,136904,156059,2633402,2610846,17644,11.351,16412,10.558,410900,137515,273385,5.267,15.738,366291,113906,252385,4.363,14.030,44609,1.709,28.059,11727,11863,56157
1981,35,23485,27381,342387,338217,4075,14.987,3695,13.589,69736,27670,42066,8.181,20.619,61184,21550,39634,6.372,18.090,8552,2.529,36.180,2682,2705,13260
1981,36,319817,362657,6006224,5970519,40218,11.119,38316,10.593,931560,297230,634330,4.978,15.603,860572,260748,599824,4.367,14.414,70988,1.189,28.827,28537,28866,149829
1981,37,93170,113786,2014941,2009123,13641,12.037,12728,11.231,274909,104207,170702,5.187,13.683,261333,82616,178717,4.112,13.007,13576,0.676,26.015,9063,9181,43232
1981,38,14141,16170,174905,174392,1901,11.843,1664,10.367,27978,11439,16539,6.559,16.043,26950,7565,19385,4.338,15.454,1028,0.589,30.907,1234,1245,5467
1981,39,159115,199297,3635266,3685883,20401,10.237,20363,10.218,443717,164887,278830,4.473,12.038,545803,145662,400141,3.952,14.808,-102086,-2.770,24.077,13996,14270,68736
1981,40,56360,66085,941105,912225,10163,15.621,8110,12.466,190449,75386,115063,8.264,20.877,133066,44380,88686,4.865,14.587,57383,6.290,29.174,6176,6263,30355
1981,41,53563,62217,826902,836565,8915,14.365,8606,13.867,134583,55681,78902,6.656,16.088,154194,48193,106001,5.761,18.432,-19611,-2.344,32.175,6255,6341,29787
1981,42,179335,217034,4014238,4033848,20743,9.532,21890,10.059,507223,190029,317194,4.711,12.574,548156,152223,395933,3.774,13.589,-40933,-1.015,25.148,15582,15840,81778
1981,44,18750,20878,340879,340905,2158,10.357,2074,9.954,48303,18312,29991,5.372,14.169,48194,12469,35725,3.658,14.137,109,0.032,28.274,1493,1501,7172
1981,45,46565,56112,966181,963103,7198,12.923,6368,11.433,140806,55013,85793,5.712,14.620,134676,36971,97705,3.839,13.984,6130,0.636,27.967,4659,4731,21564
1981,46,14685,16636,176738,179073,1763,10.549,1915,11.459,24030,9462,14568,5.284,13.419,28704,8927,19777,4.985,16.029,-4674,-2.610,26.838,1385,1395,5772
1981,47,69769,84142,1426015,1432249,10307,12.262,10140,12.063,207346,78778,128568,5.500,14.477,219242,64792,154450,4.524,15.308,-11896,-0.831,28.954,7531,7613,36531
1981,48,252337,313604,5178089,5032609,50097,16.301,37520,12.209,1062286,419343,642943,8.333,21.108,770244,260349,509895,5.173,15.305,292042,5.803,30.610,26944,27417,158333
1981,49,24171,28514,432554,436314,4571,16.224,3890,13.807,80868,35244,45624,8.078,18.534,88874,27338,61536,6.266,20.369,-8006,-1.835,37.069,2851,2890,15160
1981,50,11620,12938,170041,168269,1509,11.705,1417,10.991,25031,7342,17689,4.363,14.876,21395,6220,15175,3.696,12.715,3636,2.161,25.430,1031,1038,4269
1981,51,80976,99461,1663628,1647471,12246,12.401,10828,10.965,257862,108733,149129,6.600,15.652,224992,70370,154622,4.271,13.657,32870,1.995,27.314,7768,7921,38186
1981,53,77173,91176,1277677,1271959,12913,14.274,11486,12.697,226536,88115,138421,6.928,17.810,213711,64076,149635,5.038,16.802,12825,1.008,33.603,8267,8357,40939
1981,54,27227,32075,485348,485965,3792,11.810,3859,12.019,67046,26392,40654,5.431,13.796,68407,19648,48759,4.043,14.077,-1361,-0.280,27.593,2863,2880,13008
1981,55,82168,95685,1585494,1600177,9481,9.949,8706,9.136,195608,74569,121039,4.660,12.224,223776,50802,172974,3.175,13.984,-28168,-1.760,24.448,6371,6468,30451
1981,56,11668,13204,159782,155466,2074,15.980,1623,12.505,35849,11887,23962,7.646,23.059,26952,8829,18123,5.679,17.336,8897,5.723,34.673,1206,1211,5690
1982,01,53714,65802,1044027,1059487,7771,11.689,9131,13.735,157072,57313,99759,5.410,14.825,188371,58759,129612,5.546,17.779,-31299,-2.954,29.651,6600,6671,38147
1982,02,8115,9585,130776,125826,1855,19.910,1319,14.157,38111,13277,24834,10.552,30.289,28335,10009,18326,7.955,22.519,9776,7.769,45.039,884,894,6311
1982,04,47214,57938,848033,846593,9573,16.764,7909,13.850,160117,66147,93970,7.813,18.913,157502,48143,109359,5.687,18.604,2615,0.309,37.208,5775,5805,31970
1982,05,36447,42425,582912,592717,5465,12.825,5840,13.705,84406,30634,53772,5.168,14.241,103941,31256,72685,5.273,17.536,-19535,-3.296,28.481,4247,4278,19933
1982,06,430722,523050,8334896,8381515,74204,14.199,73319,14.029,1491715,557871,933844,6.656,17.798,1584490,531181,1053309,6.338,18.905,-92775,-1.107,35.595,51705,52440,301470
1982,08,63007,74344,1121586,1107314,12047,16.402,10260,13.969,229288,88010,141278,7.948,20.707,201451,67996,133455,6.141,18.193,27837,2.514,36.386,7456,7525,42071
1982,09,59662,68564,1290857,1296733,7280,10.632,7100,10.369,173743,53128,120615,4.097,13.399,183934,50138,133796,3.866,14.184,-10191,-0.786,26.797,5035,5110,25743
1982,10,10382,12010,240438,239579,1360,11.326,1355,11.285,31892,9397,22495,3.922,13.312,30355,9349,21006,3.902,12.670,1537,0.642,25.340,929,940,5018
1982,11,13729,15761,328927,338939,2055,13.025,2088,13.234,48509,17579,30930,5.186,14.312,68181,18351,49830,5.414,20.116,-19672,-5.804,28.624,1433,1448,12041
1982,12,194370,234182,3197201,3193215,36836,15.889,32145,13.865,615551,245542,370009,7.689,19.277,607209,203024,404185,6.358,19.016,8342,0.261,38.031,23953,24209,133806
1982,13,86244,107421,1784828,1787806,13855,12.903,13763,12.818,288390,107706,180684,6.024,16.131,293483,91473,202010,5.116,16.416,-5093,-0.285,32.262,9651,9774,52466
1982,15,17949,21814,312384,316814,2779,12.740,2779,12.740,50250,20934,29316,6.608,15.861,58881,17632,41249,5.565,18.585,-8631,-2.724,31.722,1977,1997,12127
1982,16,17239,20319,236391,240687,2695,13.170,2982,14.573,40331,17137,23194,7.120,16.757,48860,16047,32813,6.667,20.300,-8529,-3.544,33.513,2116,2128,10108
1982,17,180203,213524,3910025,3991686,23175,10.813,24789,11.566,507235,188603,318632,4.725,12.707,669922,198239,471683,4.966,16.783,-162687,-4.076,25.415,17472,17766,102014
1982,18,81622,99825,1698022,1739983,10338,10.305,11330,11.294,202719,67408,135311,3.874,11.651,286245,71929,214316,4.134,16.451,-83526,-4.800,23.301,7970,8092,39287
1982,19,54670,65192,842576,863381,6294,9.540,7858,11.911,104223,38971,65252,4.514,12.072,145389,42740,102649,4.950,16.840,-41166,-4.768,24.143,5775,5830,26582
1982,20,47375,55909,771424,780183,6619,11.811,6883,12.282,111997,41149,70848,5.274,14.355,129769,40888,88881,5.241,16.633,-17772,-2.278,28.710,5018,5077,27598
1982,21,52028,62063,938650,948098,7429,11.943,7706,12.389,137946,54671,83275,5.766,14.550,155829,43652,112177,4.604,16.436,-17883,-1.886,29.100,5676,5714,26680
1982,22,68122,81680,1337587,1332199,11452,14.185,9560,11.841,253960,90836,163124,6.819,19.063,243401,78296,165105,5.877,18.271,10559,0.793,36.541,7058,7133,45421
1982,23,19912,23067,323735,323843,2498,10.768,2760,11.898,50610,17456,33154,5.390,15.628,50255,19473,30782,6.013,15.518,355,0.110,31.037,1950,1968,10306
1982,24,63194,76553,1311035,1311947,9068,11.881,8605,11.275,210966,78804,132162,6.007,16.080,212443,62742,149701,4.782,16.193,-1477,-0.113,32.161,5854,5964,33968
1982,25,100473,117817,2324319,2332709,12403,10.557,11742,9.994,317053,105350,211703,4.516,13.592,332836,93019,239817,3.988,14.268,-15783,-0.677,27.183,8213,8296,52763
1982,26,126896,154341,2689921,2740296,16494,10.604,18891,12.145,369065,115124,253941,4.201,13.468,471410,139121,332289,5.077,17.203,-102345,-3.735,26.936,12845,13062,66567
1982,27,71090,84708,1443060,1459244,9105,10.728,9427,11.108,202420,71677,130743,4.912,13.872,233478,64412,169066,4.414,16.000,-31058,-2.128,27.743,6634,6695,34901
1982,28,36062,43084,607691,615455,5036,11.573,5901,13.560,86113,31885,54228,5.181,13.992,101092,32921,68171,5.349,16.426,-14979,-2.434,27.984,4187,4216,20885
1982,29,81824,98383,1610759,1622461,11145,11.247,12568,12.683,233651,83343,150308,5.137,14.401,255433,78344,177089,4.829,15.744,-21782,-1.343,28.802,8813,8931,43273
1982,30,17893,20489,203505,206107,2675,13.004,2838,13.796,36238,14571,21667,7.070,17.582,41493,13543,27950,6.571,20.132,-5255,-2.550,35.164,1990,2005,9363
1982,31,31870,37028,475086,483931,3902,10.474,4352,11.682,64593,24091,40502,4.978,13.348,81874,23561,58313,4.869,16.919,-17281,-3.571,26.695,3088,3158,14271
1982,32,17046,19833,353847,353030,3314,16.851,2980,15.153,74520,32683,41837,9.258,21.109,72395,25891,46504,7.334,20.507,2125,0.602,41.014,2105,2119,14407
1982,33,18770,21225,343956,339170,2621,12.378,2522,11.910,62794,20457,42337,6.031,18.514,53137,19783,33354,5.833,15.667,9657,2.847,31.334,1745,1764,9890
1982,34,136674,156332,2613277,2615338,17366,11.119,17080,10.935,399896,123198,276698,4.711,15.290,403842,122689,281153,4.691,15.441,-3946,-0.151,30.581,12230,12332,64366
1982,35,23585,27711,352138,347527,4115,14.936,3795,13.774,71799,26418,45381,7.602,20.660,62770,22167,40603,6.379,18.062,9029,2.598,36.124,2670,2699,13570
1982,36,317011,360591,5951950,5962905,39199,10.839,41304,11.421,870756,276593,594163,4.639,14.603,893927,289149,604778,4.849,14.991,-23171,-0.389,29.206,30555,30824,166394
1982,37,92092,113505,1992773,2006078,13372,11.763,13719,12.068,263362,94515,168847,4.711,13.128,288524,84023,204501,4.188,14.382,-25162,-1.254,26.256,9723,9859,44841
1982,38,14048,16186,178138,176687,1911,11.805,1915,11.830,30604,10757,19847,6.088,17.321,27612,8916,18696,5.046,15.628,2992,1.693,31.255,1378,1391,6230
1982,39,156355,197058,3512406,3569796,19923,10.051,22236,11.218,450185,149580,300605,4.190,12.611,565404,150917,414487,4.228,15.839,-115219,-3.228,25.222,15044,15293,78568
1982,40,57826,67985,995022,968164,10739,16.018,8857,13.211,214067,78851,135216,8.144,22.111,160140,55749,104391,5.758,16.541,53927,5.570,33.081,6610,6681,36688
1982,41,51531,60681,771931,801663,8223,13.378,9795,15.935,117245,48819,68426,6.090,14.625,176592,49791,126801,6.211,22.028,-59347,-7.403,29.250,7103,7194,32616
1982,42,176891,215426,3962006,3983138,21029,9.725,22645,10.472,538573,177127,361446,4.447,13.521,579541,164513,415028,4.130,14.550,-40968,-1.029,27.043,15560,15827,82730
1982,44,18480,20639,333966,337559,2035,9.797,2299,11.068,45513,15547,29966,4.606,13.483,52469,14935,37534,4.424,15.544,-6956,-2.061,26.966,1647,1659,9071
1982,45,45731,55696,948356,957131,6826,12.208,7259,12.983,136126,50972,85154,5.325,14.222,154332,41587,112745,4.345,16.124,-18206,-1.902,28.445,5224,5277,26328
1982,46,14429,16402,173777,175847,1785,10.803,2028,12.273,26019,10739,15280,6.107,14.796,30167,9183,20984,5.222,17.155,-4148,-2.359,29.593,1468,1481,6253
1982,47,68749,83717,1404455,1416347,10657,12.695,11120,13.246,215834,80950,134884,5.715,15.239,238333,68736,169597,4.853,16.827,-22499,-1.589,30.478,8019,8124,41480
1982,48,258663,324146,5470034,5324534,50884,15.952,40550,12.712,1174841,412709,762132,7.751,22.065,886538,301441,585097,5.661,16.650,288303,5.415,33.300,29367,29895,181644
1982,49,23959,28621,435749,434214,4218,14.757,4141,14.488,80412,30697,49715,7.070,18.519,77411,26103,51308,6.012,17.828,3001,0.691,35.656,2969,2998,16799
1982,50,11725,13089,167772,168752,1640,12.603,1487,11.427,22236,7548,14688,4.473,13.177,24360,7908,16452,4.686,14.435,-2124,-1.259,26.353,1093,1098,4484
1982,51,80427,99812,1651418,1655798,12051,12.090,11783,11.821,247828,89265,158563,5.391,14.967,256222,76997,179225,4.650,15.474,-8394,-0.507,29.935,8286,8405,44107
1982,53,76421,91145,1234320,1250082,12695,13.921,12785,14.020,211011,79238,131773,6.339,16.880,242739,72187,170552,5.775,19.418,-31728,-2.538,33.760,8871,8952,44621
1982,54,26557,31551,473519,480059,3552,11.159,4112,12.918,64254,22337,41917,4.653,13.385,77219,21938,55281,4.570,16.085,-12965,-2.701,26.769,2919,2951,12892
1982,55,81244,95332,1553778,1568792,9499,9.944,9883,10.346,192907,64598,128309,4.118,12.297,223653,56173,167480,3.581,14.256,-30746,-1.960,24.593,7004,7082,32074
1982,56,11787,13498,158600,159320,2169,16.245,1876,14.051,32284,12552,19732,7.878,20.264,33693,10439,23254,6.552,21.148,-1409,-0.884,40.527,1397,1405,6805
1983,01,53814,65471,1008620,1027855,8360,12.735,8714,13.274,162809,55289,107520,5.379,15.840,200970,76820,124150,7.474,19.552,-38161,-3.713,31.679,5579,5711,31797
1983,02,9174,10820,136155,133221,2529,24.789,1293,12.674,38110,17187,20923,12.901,28.607,32396,11705,20691,8.786,24.318,5714,4.289,48.635,872,890,6468
1983,04,49266,60368,856642,852476,10102,17.075,7690,12.998,174995,67745,107250,7.947,20.528,166550,55279,111271,6.485,19.537,8445,0.991,39.074,5200,5269,30468
1983,05,37122,43186,581585,581621,5833,13.624,5087,11.882,91784,32117,59667,5.522,15.781,92051,31887,60164,5.482,15.827,-267,-0.046,31.561,3608,3656,16444
1983,06,438902,531259,8280440,8291405,75920,14.401,67750,12.852,1567694,548354,1019340,6.614,18.907,1593075,553948,1039127,6.681,19.214,-25381,-0.306,37.815,44940,45734,271458
1983,08,64865,76473,1100338,1112354,12277,16.276,10187,13.506,205818,77216,128602,6.942,18.503,230287,70265,160022,6.317,20.703,-24469,-2.200,37.006,7167,7240,41256
1983,09,60884,69976,1295443,1292671,8025,11.592,6536,9.441,182498,57752,124746,4.468,14.118,177471,48834,128637,3.778,13.729,5027,0.389,27.458,4522,4566,21814
1983,10,10793,12458,248481,244755,1645,13.443,1203,9.831,38020,13085,24935,5.346,15.534,30136,8299,21837,3.391,12.313,7884,3.221,24.625,788,797,4215
1983,11,14187,16235,334784,332258,2249,14.053,1787,11.166,61678,22308,39370,6.714,18.563,57791,17212,40579,5.180,17.393,3887,1.170,34.787,1201,1215,8215
1983,12,203807,245004,3236074,3217719,40558,16.922,29909,12.479,633567,263957,369610,8.203,19.690,597329,210737,386592,6.549,18.564,36238,1.126,37.127,21402,21698,119553
1983,13,89248,110897,1797323,1788570,15834,14.506,12357,11.320,311310,107459,203851,6.008,17.406,294604,105888,188716,5.920,16.471,16706,0.934,32.943,8285,8409,47896
1983,15,18637,22540,310196,311054,3183,14.362,2429,10.960,51819,22056,29763,7.091,16.659,53463,18772,34691,6.035,17.188,-1644,-0.529,33.318,1648,1687,11486
1983,16,17551,20630,235080,235706,2881,14.070,2573,12.566,41441,17163,24278,7.282,17.582,42567,16572,25995,7.031,18.059,-1126,-0.478,35.163,1794,1823,8818
1983,17,183223,216843,3846370,3882039,25615,11.900,22437,10.423,570399,199108,371291,5.129,14.693,643979,182161,461818,4.692,16.589,-73580,-1.895,29.387,15548,15845,89679
1983,18,83255,101407,1664173,1681308,12369,12.291,10823,10.755,229134,86294,142840,5.133,13.628,263307,68760,194547,4.090,15.661,-34173,-2.033,27.257,7682,7816,38357
1983,19,54838,65355,847949,846251,6792,10.402,6666,10.210,147600,73095,74505,8.638,17.442,146385,47585,98800,5.623,17.298,1215,0.144,34.596,4820,4868,22394
1983,20,48156,56687,732337,751994,6935,12.316,6179,10.973,108066,38267,69799,5.089,14.371,146998,49108,97890,6.530,19.548,-38932,-5.177,28.741,4378,4448,21433
1983,21,52213,61997,913500,926024,7696,12.411,7724,12.456,137309,55101,82208,5.950,14.828,162323,59172,103151,6.390,17.529,-25014,-2.701,29.656,5171,5221,27016
1983,22,69621,83111,1239699,1289876,11258,13.662,9840,11.941,211201,77014,134187,5.971,16.374,311738,87299,224439,6.768,24.168,-100537,-7.794,32.747,7075,7164,45913
1983,23,20189,23360,328060,325779,2884,12.442,2523,10.885,50771,16162,34609,4.961,15.585,46290,16081,30209,4.936,14.209,4481,1.375,28.418,1688,1708,8294
1983,24,65766,79361,1342280,1328323,10350,13.272,7590,9.733,226799,75107,151692,5.654,17.074,199675,64982,134693,4.892,15.032,27124,2.042,30.064,5082,5166,29537
1983,25,102837,120425,2356705,2342515,13734,11.528,11163,9.370,366525,120517,246008,5.145,15.647,337991,99262,238729,4.237,14.429,28534,1.218,28.857,7581,7700,50534
1983,26,130051,157662,2679726,2689227,19466,12.474,16249,10.412,408388,140846,267542,5.237,15.186,427898,132088,295810,4.912,15.912,-19510,-0.725,30.372,10795,11021,66838
1983,27,72590,86232,1418719,1432201,9888,11.564,8438,9.868,208010,79457,128553,5.548,14.524,235717,66768,168949,4.662,16.458,-27707,-1.935,29.048,5723,5805,31840
1983,28,36372,43098,588113,597261,5563,12.910,5545,12.869,89641,31842,57799,5.331,15.009,107893,41908,65985,7.017,18.065,-18252,-3.056,30.017,3607,3657,17017
1983,29,83961,100460,1599517,1606028,12911,12.981,10911,10.970,245301,81514,163787,5.076,15.274,258325,80784,177541,5.030,16.085,-13024,-0.811,30.548,7423,7554,39448
1983,30,18362,20975,199869,201772,2919,14.080,2433,11.735,35963,14814,21149,7.342,17.824,40042,13658,26384,6.769,19.845,-4079,-2.022,35.647,1681,1707,8807
1983,31,32331,37484,467811,471382,4247,11.399,3793,10.181,69090,24218,44872,5.138,14.657,76629,25240,51389,5.354,16.256,-7539,-1.599,29.314,2596,2627,12115
1983,32,17311,20106,339220,347215,3192,15.980,2931,14.673,60414,27206,33208,7.836,17.400,76969,26915,50054,7.752,22.168,-16555,-4.768,34.799,1980,2002,16438
1983,33,19394,21949,340632,340215,2972,13.771,2238,10.370,54255,19944,34311,5.862,15.947,53297,16641,36656,4.891,15.666,958,0.282,31.331,1525,1544,8715
1983,34,140132,159975,2641734,2628133,19448,12.294,15877,10.037,441552,143835,297717,5.473,16.801,415948,138901,277047,5.285,15.827,25604,0.974,31.654,11009,11101,58818
1983,35,24557,28704,345582,349010,4528,16.048,3551,12.585,67439,28095,39344,8.050,19.323,74177,24282,49895,6.957,21.254,-6738,-1.931,38.646,2426,2459,14075
1983,36,324036,367855,5941400,5949778,45228,12.418,37959,10.422,947761,321210,626551,5.399,15.929,964723,312733,651990,5.256,16.214,-16962,-0.285,31.859,27837,28173,177622
1983,37,95056,116836,1997349,1990380,15457,13.418,12179,10.572,288233,105412,182821,5.296,14.481,274601,85239,189362,4.283,13.796,13632,0.685,27.593,8697,8839,42527
1983,38,14252,16398,174857,176508,1967,12.073,1755,10.772,27531,11216,16315,6.354,15.598,30884,9944,20940,5.634,17.497,-3353,-1.900,31.195,1250,1272,6406
1983,39,158071,198487,3420220,3452260,21692,10.972,20131,10.182,490763,180671,310092,5.233,14.216,554101,151577,402524,4.391,16.050,-63338,-1.835,28.431,13072,13389,71461
1983,40,58934,69169,922036,957877,10216,14.900,9004,13.132,162030,66393,95637,6.931,16.916,234021,68427,165594,7.144,24.431,-71991,-7.516,33.831,6765,6847,42525
1983,41,51716,60858,758769,765707,8381,13.788,8234,13.546,128452,44816,83636,5.853,16.776,142019,47509,94510,6.205,18.547,-13567,-1.772,33.551,5633,5768,29181
1983,42,180159,218717,3881132,3924782,23887,11.003,20633,9.504,555666,189278,366388,4.823,14.158,644866,180939,463927,4.610,16.431,-89200,-2.273,28.316,13591,13907,79524
1983,44,18597,20694,332056,332704,2219,10.762,2067,10.025,45133,11762,33371,3.535,13.566,46323,14947,31376,4.493,13.923,-1190,-0.358,27.131,1447,1455,7474
1983,45,47055,57256,935656,942489,7910,14.004,6368,11.274,141324,51566,89758,5.471,14.995,155409,46145,109264,4.896,16.489,-14085,-1.494,29.990,4538,4592,23694
1983,46,14536,16496,171522,172513,1846,11.218,1765,10.726,25326,8981,16345,5.206,14.681,27214,9009,18205,5.222,15.775,-1888,-1.094,29.361,1215,1239,5429
1983,47,69488,84006,1387968,1397236,11267,13.436,10973,13.085,221571,81931,139640,5.864,15.858,239772,88943,150829,6.366,17.160,-18201,-1.303,31.716,7104,7233,40395
1983,48,267910,334938,5254284,5372391,53043,16.095,42294,12.833,989422,399408,590014,7.434,18.417,1226070,346142,879928,6.443,22.822,-236648,-4.405,36.834,29678,30327,189956
1983,49,24495,29261,429086,432489,4375,15.114,3745,12.938,80324,33144,47180,7.664,18.572,86984,28124,58860,6.503,20.112,-6660,-1.540,37.145,2530,2574,15148
1983,50,11868,13238,166911,167491,1649,12.538,1478,11.237,22756,7957,14799,4.751,13.586,23961,6461,17500,3.858,14.306,-1205,-0.719,27.173,1043,1048,4143
1983,51,82826,102654,1653757,1649246,13219,13.058,10372,10.246,258917,86610,172307,5.251,15.699,249467,77633,171834,4.707,15.126,9450,0.573,30.252,7041,7221,39071
1983,53,79041,93853,1222272,1228762,13941,15.072,11225,12.136,216555,80447,136108,6.547,17.624,228491,69712,158779,5.673,18.595,-11936,-0.971,35.248,7545,7712,41094
1983,54,26399,31377,430579,449742,3639,11.567,3806,12.098,57177,24228,32949,5.387,12.713,95483,25247,70236,5.614,21.231,-38306,-8.517,25.427,2616,2670,13622
1983,55,82717,96822,1509618,1531996,10585,11.030,8870,9.243,197107,68831,128276,4.493,12.866,241579,59507,182072,3.884,15.769,-44472,-2.903,25.732,6102,6211,32625
1983,56,11771,13476,138556,148623,1926,14.277,1954,14.485,25139,11237,13902,7.561,16.915,45089,12315,32774,8.286,30.338,-19950,-13.423,33.829,1401,1420,7575
1984,01,57420,69650,1099112,1054244,10803,15.987,6647,9.837,214952,74540,140412,7.070,20.389,125009,41642,83367,3.950,11.858,89943,8.532,23.715,4928,4983,26825
1984,02,10243,11970,146084,141895,2616,22.951,1472,12.915,37912,15532,22380,10.946,26.718,29572,10119,19453,7.131,20.841,8340,5.878,41.682,1032,1052,6790
1984,04,53154,64517,965019,911489,11422,18.288,7300,11.688,233666,85725,147941,9.405,25.636,127046,48838,78208,5.358,13.938,106620,11.697,27.877,5003,5107,27569
1984,05,39255,45423,630611,606987,7088,15.990,4896,11.045,118994,39783,79211,6.554,19.604,72292,27832,44460,4.585,11.910,46702,7.694,23.820,3540,3617,16855
1984,06,462353,556439,8956008,8604728,86063,15.820,61201,11.250,1948519,674242,1274277,7.836,22.645,1246963,474845,772118,5.518,14.492,701556,8.153,28.983,41966,42719,251383
1984,08,68517,80543,1169745,1135831,13646,17.377,9617,12.247,251193,100410,150783,8.840,22.115,184032,71751,112281,6.317,16.202,67161,5.913,32.405,7053,7138,38667
1984,09,63583,72865,1363758,1327517,8912,12.478,6027,8.439,220445,67950,152495,5.119,16.606,148269,47870,100399,3.606,11.169,72176,5.437,22.338,4316,4373,24615
1984,10,11166,12869,240161,233820,1712,13.518,1303,10.289,41063,14051,27012,6.009,17.562,28518,9717,18801,4.156,12.197,12545,5.365,24.393,879,885,5318
1984,11,14219,16342,351304,342649,2192,13.457,2086,12.806,63799,21128,42671,6.166,18.619,46114,17334,28780,5.059,13.458,17685,5.161,26.916,1487,1519,10331
1984,12,216231,259125,3554269,3398230,44031,17.461,30105,11.939,794352,308264,486088,9.071,23.375,483348,189489,293859,5.576,14.224,311004,9.152,28.447,22131,22464,120190
1984,13,95283,117658,1975625,1886728,18434,16.126,11748,10.277,399611,141626,257985,7.506,21.180,222223,84292,137931,4.468,11.778,177388,9.402,23.556,8118,8225,46855
1984,15,18970,22909,317889,314244,2915,12.833,2527,11.125,52818,18549,34269,5.903,16.808,45456,16329,29127,5.196,14.465,7362,2.343,28.930,1719,1777,9406
1984,16,18424,21572,249300,242245,3243,15.372,2292,10.864,47382,16675,30707,6.884,19.560,33495,12544,20951,5.178,13.827,13887,5.733,27.654,1686,1698,8122
1984,17,186381,220669,4000296,3922494,27139,12.405,23357,10.676,664874,217412,447462,5.543,16.950,506002,204100,301902,5.203,12.900,158872,4.050,25.800,16871,17107,120548
1984,18,85865,104299,1774043,1719631,14187,13.788,11382,11.062,323641,114287,209354,6.646,18.820,214812,94606,120206,5.502,12.492,108829,6.329,24.984,8564,8691,50086
1984,19,55930,66604,881249,864665,7720,11.697,6514,9.870,135388,45617,89771,5.276,15.658,102617,34921,67696,4.039,11.868,32771,3.790,23.736,4800,4880,21599
1984,20,49938,58666,778878,755827,8062,13.978,6085,10.550,145766,49993,95773,6.614,19.286,98441,38058,60383,5.035,13.024,47325,6.261,26.049,4443,4490,24094
1984,21,54907,65163,988918,951457,9370,14.737,6207,9.762,190788,90594,100194,9.522,20.052,116363,38918,77445,4.090,12.230,74425,7.822,24.460,4709,4774,27598
1984,22,71641,85595,1268768,1252553,12484,14.798,10016,11.873,235444,88762,146682,7.086,18.797,203974,69019,134955,5.510,16.285,31470,2.512,32.569,7413,7539,39348
1984,23,21589,24870,347557,337348,3565,14.779,2070,8.581,56471,18179,38292,5.389,16.740,36103,13258,22845,3.930,10.702,20368,6.038,21.404,1465,1489,6591
1984,24,68625,82743,1447709,1393735,11319,13.959,8011,9.879,275119,93661,181458,6.720,19.740,166731,58246,108485,4.179,11.963,108388,7.777,23.926,5571,5659,31474
1984,25,107752,125821,2509279,2424927,15457,12.556,10029,8.147,434315,137151,297164,5.656,17.910,265481,83189,182292,3.431,10.948,168834,6.962,21.896,7048,7147,43992
1984,26,135321,163274,2834538,2720937,20953,13.057,15356,9.569,518319,156503,361816,5.752,19.049,290304,116505,173799,4.282,10.669,228015,8.380,21.339,10794,10976,56050
1984,27,75774,89713,1517654,1467426,11711,13.308,8290,9.420,269859,87470,182389,5.961,18.390,169890,63401,106489,4.321,11.577,99969,6.813,23.155,5831,5954,35826
1984,28,38440,45578,636731,612751,6923,15.610,4464,10.066,120794,46017,74777,7.510,19.713,72411,23752,48659,3.876,11.817,48383,7.896,23.635,3366,3396,15777
1984,29,86775,103659,1692260,1643874,14296,14.004,11155,10.927,302225,100545,201680,6.116,18.385,205719,72025,133694,4.381,12.514,96506,5.871,25.029,8106,8211,41933
1984,30,19305,21973,208484,204250,3338,15.543,2343,10.910,41015,17399,23616,8.519,20.081,32413,10984,21429,5.378,15.869,8602,4.212,31.739,1678,1698,7290
1984,31,33374,38634,488938,478290,4799,12.606,3669,9.638,82839,32001,50838,6.691,17.320,61403,20583,40820,4.303,12.838,21436,4.482,25.676,2668,2705,12905
1984,32,18451,21339,371958,355703,3702,17.858,2485,11.987,78153,28121,50032,7.906,21.971,45597,17147,28450,4.821,12.819,32556,9.153,25.638,1728,1743,9690
1984,33,20967,23644,385049,363562,3694,16.202,2006,8.798,81177,30829,50348,8.480,22.328,38390,13118,25272,3.608,10.559,42787,11.769,21.119,1439,1465,7866
1984,34,144970,165526,2804414,2718980,20728,12.734,15241,9.363,517402,161291,356111,5.932,19.029,347423,116219,231204,4.274,12.778,169979,6.252,25.555,10833,10941,56910
1984,35,25750,29943,367155,356712,4835,16.480,3627,12.362,79214,31662,47552,8.876,22.207,58059,20489,37570,5.744,16.276,21155,5.931,32.552,2572,2607,13334
1984,36,330819,375297,6189405,6069358,45822,12.330,38510,10.362,1016874,325211,691663,5.358,16.754,774022,256772,517250,4.231,12.753,242852,4.001,25.506,28588,28856,150747
1984,37,101694,124144,2166092,2082749,19954,16.557,12699,10.537,379799,122921,256878,5.902,18.235,213050,80760,132290,3.878,10.229,166749,8.006,20.459,9757,9829,50228
1984,38,14790,16997,181332,178139,2213,13.252,1617,9.683,31162,12829,18333,7.202,17.493,24763,8777,15986,4.927,13.901,6399,3.592,27.802,1175,1185,5471
1984,39,163290,203913,3592771,3498379,23627,11.740,18296,9.091,585175,177267,407908,5.067,16.727,395632,132788,262844,3.796,11.309,189543,5.418,22.618,12406,12659,65603
1984,40,60619,71098,932768,926332,11016,15.708,9081,12.949,176452,71283,105169,7.695,19.048,162772,59482,103290,6.421,17.572,13680,1.477,35.143,6967,7048,37938
1984,41,54383,63717,807499,782604,9796,15.727,6936,11.136,159412,53734,105678,6.866,20.369,108845,37923,70922,4.846,13.908,50567,6.461,27.816,5012,5079,22442
1984,42,184526,223520,3976365,3914145,25635,11.592,20895,9.448,616660,189131,427529,4.832,15.755,492318,178401,313917,4.558,12.578,124342,3.177,25.156,14153,14389,105855
1984,44,19329,21421,353955,343171,2565,12.169,1881,8.924,59272,16154,43118,4.707,17.272,37708,12298,25410,3.584,10.988,21564,6.284,21.976,1329,1356,6814
1984,45,50193,60769,1004510,971297,10003,16.944,6534,11.068,180511,62452,118059,6.430,18.585,113625,45097,68528,4.643,11.698,66886,6.886,23.397,4912,4963,26064
1984,46,15083,17106,181885,176584,2233,13.287,1634,9.722,31894,11209,20685,6.348,18.062,21580,8101,13479,4.588,12.221,10314,5.841,24.442,1171,1182,4416
1984,47,74065,89433,1521060,1455198,14079,16.232,8681,10.009,295456,112967,182489,7.763,20.303,164069,55242,108827,3.796,11.275,131387,9.029,22.549,6512,6618,37662
1984,48,280182,349088,5534589,5389899,57605,16.843,43465,12.708,1199034,465888,733146,8.644,22.246,911054,328419,582635,6.093,16.903,287980,5.343,33.806,31422,32137,192550
1984,49,25465,30327,460283,445605,4592,15.409,3539,11.876,92039,32923,59116,7.388,20.655,63008,26130,36878,5.864,14.140,29031,6.515,28.280,2476,2533,14680
1984,50,12771,14171,177576,172425,2130,15.537,1206,8.797,29398,10106,19292,5.861,17.050,19107,6421,12686,3.724,11.081,10291,5.968,22.163,878,884,4029
1984,51,88167,108724,1776861,1713902,16272,15.389,10294,9.736,322667,111794,210873,6.523,18.826,196199,74802,121397,4.364,11.448,126468,7.379,22.895,7495,7598,41235
1984,53,83972,99083,1311765,1280963,15447,16.008,10271,10.644,254193,90502,163691,7.065,19.844,194927,69572,125355,5.431,15.217,59266,4.627,30.434,7319,7394,35776
1984,54,27489,32521,441200,436043,4649,14.551,3507,10.977,70166,25188,44978,5.776,16.092,59569,23049,36520,5.286,13.661,10597,2.430,27.323,2574,2620,12779
1984,55,85521,99976,1601802,1555206,12145,12.338,9058,9.202,259864,77668,182196,4.994,16.709,166058,57468,108590,3.695,10.678,93806,6.032,21.355,6439,6532,32370
1984,56,11885,13616,138632,138636,1912,14.115,1772,13.081,27866,12819,15047,9.247,20.100,27953,9945,18008,7.173,20.163,-87,-0.063,40.200,1227,1239,5489
1985,01,58435,70929,1163406,1145299,9895,14.079,8605,12.243,203575,68348,135227,5.968,17.775,167516,67539,99977,5.897,14.626,36059,3.148,29.253,6164,6270,38651
1985,02,10568,12353,152537,149371,2411,19.826,2026,16.660,39217,14462,24755,9.682,26.255,32823,14661,18162,9.815,21.974,6394,4.281,43.948,1502,1516,9893
1985,04,56223,67854,1075194,1020135,11996,18.124,8667,13.094,275332,101723,173609,9.972,26.990,165298,69299,95999,6.793,16.204,110034,10.786,32.407,6119,6238,43953
1985,05,39571,45802,647100,638577,6222,13.640,5849,12.822,112993,37096,75897,5.809,17.694,95741,40636,55105,6.364,14.993,17252,2.702,29.986,4394,4460,25378
1985,06,476452,570275,9335975,9145986,86874,15.420,73059,12.968,1946854,696948,1249906,7.620,21.286,1567062,641185,925877,7.011,17.134,379792,4.153,34.268,50852,51779,367189
1985,08,69713,81894,1208311,1189390,13287,16.360,11930,14.689,249083,89877,159206,7.557,20.942,212142,89524,122618,7.527,17.836,36941,3.106,35.672,8736,8901,57880
1985,09,64968,74425,1409801,1387154,9067,12.312,7509,10.196,218019,64276,153743,4.634,15.717,172756,64799,107957,4.671,12.454,45263,3.263,24.908,5492,5553,35523
1985,10,11500,13234,276706,258744,1794,13.748,1424,10.913,68700,36231,32469,14.003,26.551,33558,12304,21254,4.755,12.970,35142,13.582,25.939,941,960,5944
1985,11,14009,16189,370751,361520,2086,12.827,2232,13.725,79904,22381,57523,6.191,22.102,60141,27594,32547,7.633,16.636,19763,5.467,33.271,1675,1697,15676
1985,12,224674,269233,3770477,3661689,45840,17.351,35744,13.530,832581,323934,508647,8.847,22.738,613603,252624,360979,6.899,16.757,218978,5.980,33.515,26495,26956,164312
1985,13,99184,122022,2124273,2049999,18488,15.429,14096,11.764,426511,142733,283778,6.963,20.805,276531,108045,168486,5.270,13.489,149980,7.316,26.979,9821,10001,62031
1985,15,19068,23000,325115,321406,2797,12.185,2705,11.784,54278,19090,35188,5.940,16.888,47163,18343,28820,5.707,14.674,7115,2.214,29.348,1867,1901,10035
1985,16,18562,21744,253891,251624,3083,14.232,2920,13.480,45461,16458,29003,6.541,18.067,40740,16567,24173,6.584,16.191,4721,1.876,32.382,2115,2148,11213
1985,17,187361,221909,4087179,4045973,26361,11.913,25094,11.341,677249,239986,437263,5.931,16.739,596824,242921,353903,6.004,14.751,80425,1.988,29.502,17939,18332,125236
1985,18,86538,105105,1809781,1791393,12632,12.066,11803,11.274,283954,98584,185370,5.503,15.851,247135,93310,153825,5.209,13.796,36819,2.055,27.591,8441,8627,55861
1985,19,54532,65120,854466,867612,6543,9.935,8024,12.183,120278,40004,80274,4.611,13.863,144620,75632,68988,8.717,16.669,-24342,-2.806,27.726,5894,5989,28622
1985,20,49851,58569,808416,793303,7082,12.083,7164,12.223,150183,62244,87939,7.846,18.931,118811,54538,64273,6.875,14.977,31372,3.955,29.954,5215,5302,30904
1985,21,55357,65603,1024858,1005786,8304,12.701,7856,12.016,167198,58027,109171,5.769,16.624,128715,52988,75727,5.268,12.797,38483,3.826,25.595,5784,5879,31288
1985,22,71268,85247,1263734,1265649,11346,13.283,11682,13.677,226508,82357,144151,6.507,17.897,230344,88761,141583,7.013,18.200,-3837,-0.303,35.793,8668,8820,55423
1985,23,22360,25630,352799,350157,3505,13.881,2746,10.875,59618,22212,37406,6.343,17.026,54255,23190,31065,6.623,15.495,5363,1.532,30.989,1898,1933,10944
1985,24,70998,85388,1529893,1479431,12495,14.865,9835,11.700,308663,108979,199684,7.366,20.864,207846,87433,120413,5.910,14.049,100817,6.815,28.098,6998,7148,51095
1985,25,110924,129351,2620030,2564680,16029,12.565,12474,9.778,453667,128049,325618,4.993,17.689,341473,126053,215420,4.915,13.314,112194,4.375,26.629,8956,9171,72042
1985,26,138031,166378,2960433,2898604,20666,12.539,17547,10.646,527216,185638,341578,6.404,18.189,403309,170939,232370,5.897,13.914,123907,4.275,27.828,12621,12897,84177
1985,27,76390,90422,1586749,1552063,11156,12.387,10436,11.588,282197,93641,188556,6.033,18.182,212943,91004,121939,5.863,13.720,69254,4.462,27.440,7512,7676,53216
1985,28,38436,45751,646831,641973,6004,13.147,5836,12.779,106895,38536,68359,6.003,16.651,97609,38118,59491,5.938,15.205,9286,1.446,30.409,4209,4266,23143
1985,29,88164,105142,1737370,1714478,13852,13.270,12347,11.828,291284,99817,191467,5.822,16.990,245197,107392,137805,6.264,14.302,46087,2.688,28.603,8904,9044,56741
1985,30,19242,21847,206024,207262,2858,13.045,2980,13.602,35298,12979,22319,6.262,17.031,37674,16125,21549,7.780,18.177,-2376,-1.146,34.061,2146,2157,10125
1985,31,33016,38255,497035,493667,4348,11.310,4725,12.291,80926,30701,50225,6.219,16.393,74189,33463,40726,6.778,15.028,6737,1.365,30.056,3491,3532,21197
1985,32,18874,21781,388960,379585,3536,16.401,3093,14.346,78126,26749,51377,7.047,20.582,59328,28163,31165,7.419,15.630,18798,4.952,31.259,2170,2192,15171
1985,33,22277,25043,406154,394635,3976,16.334,2574,10.574,81211,26922,54289,6.822,20.579,58063,24044,34019,6.093,14.713,23148,5.866,29.426,1880,1910,15001
1985,34,149041,170208,2923722,2870724,22266,13.265,17571,10.468,530713,164633,366080,5.735,18.487,426393,156986,269407,5.469,14.853,104320,3.634,29.706,12705,12927,93593
1985,35,26033,30249,385683,376565,4563,15.160,4263,14.163,83721,29208,54513,7.756,22.233,65464,29619,35845,7.866,17.385,18257,4.848,34.769,2989,3023,17362
1985,36,336697,381792,6435249,6328235,48850,12.906,42289,11.172,1096753,350553,746200,5.540,17.331,882881,333151,549730,5.265,13.951,213872,3.380,27.903,31974,32455,200529
1985,37,105338,128242,2247394,2206234,17540,13.899,13443,10.653,365085,118728,246357,5.381,16.548,282782,99861,182921,4.526,12.817,82303,3.730,25.635,9635,9810,58947
1985,38,14533,16739,182246,181849,1824,10.812,2085,12.360,28356,9867,18489,5.426,15.593,27731,10513,17218,5.781,15.250,625,0.344,30.499,1510,1537,7469
1985,39,164302,204641,3687367,3634567,22561,11.045,21822,10.683,569497,161983,407514,4.457,15.669,465261,186376,278885,5.128,12.801,104236,2.868,25.602,15044,15430,100551
1985,40,59783,70353,974526,951953,9953,14.074,10686,15.110,213395,86429,126966,9.079,22.417,168378,70351,98027,7.390,17.688,45017,4.729,35.375,8173,8245,47257
1985,41,54968,64190,833035,820119,9182,14.357,8715,13.626,158036,56430,101606,6.881,19.270,132376,54282,78094,6.619,16.141,25660,3.129,32.282,6274,6454,33736
1985,42,186153,225265,4051678,4015372,26137,11.648,24386,10.868,614458,196245,418213,4.887,15.303,541606,222126,319480,5.532,13.488,72852,1.814,26.977,16686,17091,123490
1985,44,19715,21849,359159,356967,2676,12.369,2247,10.386,54767,16511,38256,4.625,15.342,50021,17995,32026,5.041,14.013,4746,1.330,28.026,1664,1687,11930
1985,45,51749,62625,1062884,1045625,8824,14.302,6972,11.300,178019,59869,118150,5.726,17.025,143299,51205,92094,4.897,13.705,34720,3.321,27.409,5008,5082,29934
1985,46,15050,17083,187554,184744,1981,11.588,2005,11.729,30616,11748,18868,6.359,16.572,24891,9130,15761,4.942,13.473,5725,3.099,26.946,1449,1477,6515
1985,47,75126,90798,1567600,1544271,12405,13.767,11018,12.228,271007,91729,179278,5.940,17.549,223735,90977,132758,5.891,14.488,47272,3.061,28.976,7859,7949,45812
1985,48,283452,353327,5682219,5586421,54637,15.557,50397,14.350,1183008,456435,726573,8.170,21.176,993817,406894,586923,7.284,17.790,189191,3.387,35.580,36782,37485,244321
1985,49,25703,30545,479073,469630,4575,15.033,4353,14.303,90256,31843,58413,6.780,19.219,71199,29809,41390,6.347,15.161,19057,4.058,30.321,3113,3180,19849
1985,50,13253,14663,182368,179842,2120,14.709,1620,11.240,29685,10594,19091,5.891,16.506,24650,10347,14303,5.753,13.707,5035,2.800,27.413,1193,1212,5598
1985,51,90940,111997,1879092,1827847,16594,15.035,13341,12.087,339205,117716,221489,6.440,18.558,236802,99005,137797,5.416,12.955,102403,5.602,25.910,9906,10056,59248
1985,53,85154,100376,1343470,1328162,14476,14.514,13199,13.234,245918,85550,160368,6.441,18.516,215254,83087,132167,6.256,16.207,30664,2.309,32.414,9241,9402,50631
1985,54,27114,32126,442199,441972,4192,12.968,4591,14.202,66287,26977,39310,6.104,14.998,66078,25741,40337,5.824,14.951,209,0.047,29.901,3398,3456,17172
1985,55,85673,100125,1635751,1619116,11166,11.162,10991,10.987,238677,75947,162730,4.691,14.741,206052,78614,127438,4.855,12.726,32625,2.015,25.452,7952,8132,48795
1985,56,11834,13533,138604,138470,1868,13.764,1946,14.338,26577,10710,15867,7.735,19.193,26372,10428,15944,7.531,19.045,205,0.148,38.091,1354,1365,6267
1986,01,59638,72877,1214885,1188332,10467,14.558,8507,11.832,228960,87677,141283,7.378,19.267,176107,61103,115004,5.142,14.820,52853,4.448,29.639,6059,6177,35323
1986,02,10569,12386,145187,148969,2297,18.569,2265,18.310,34046,14591,19455,9.795,22.854,41570,16032,25538,10.762,27.905,-7524,-5.051,45.709,1620,1702,12498
1986,04,58630,71300,1140911,1108624,12659,18.194,9214,13.243,267812,111286,156526,10.038,24.157,203058,68301,134757,6.161,18.316,64754,5.841,36.632,6607,6683,44257
1986,05,39824,46205,669391,656304,6224,13.532,5805,12.621,124602,43628,80974,6.648,18.985,98434,35417,63017,5.396,14.998,26168,3.987,29.996,4292,4364,22492
1986,06,490778,590423,9673488,9485918,92093,15.871,71745,12.365,2019856,757287,1262569,7.983,21.293,1643403,572246,1071157,6.033,17.325,376453,3.969,34.649,49639,50511,323943
1986,08,70193,83138,1219180,1212587,13299,16.120,12020,14.570,242517,101586,140931,8.378,20.000,230004,88490,141514,7.298,18.968,12513,1.032,37.936,8659,8786,56948
1986,09,67055,76841,1440808,1425361,9779,12.932,7330,9.694,218448,75469,142979,5.295,15.326,187269,55976,131293,3.927,13.138,31179,2.187,26.277,5179,5248,31018
1986,10,12094,13942,284534,280752,2056,15.132,1347,9.914,46719,15501,31218,5.521,16.641,39132,11371,27761,4.050,13.938,7587,2.702,27.877,920,933,4830
1986,11,14257,16620,382780,376555,2211,13.480,1776,10.828,64606,23378,41228,6.208,17.157,52313,16509,35804,4.384,13.893,12293,3.265,27.785,1237,1251,10064
1986,12,234208,281567,3967369,3869301,48486,17.607,36096,13.108,870890,353251,517639,9.130,22.508,673964,256403,417561,6.627,17.418,196926,5.089,34.836,26502,26886,164855
1986,13,102919,127210,2238346,2182831,19796,15.887,14589,11.708,432431,159715,272716,7.317,19.811,321135,112795,208340,5.167,14.712,111296,5.099,29.424,10066,10197,64243
1986,15,19383,23589,342927,334407,3103,13.323,2507,10.764,66745,26610,40135,7.957,19.959,49413,17993,31420,5.381,14.776,17332,5.183,29.553,1655,1676,10528
1986,16,18674,21929,257961,256046,3021,13.835,2835,12.983,45664,16911,28753,6.605,17.834,42146,14718,27428,5.748,16.460,3518,1.374,32.921,1988,2013,9970
1986,17,190045,226038,4200110,4144043,27273,12.180,23037,10.288,676145,220676,455469,5.325,16.316,564865,183043,381822,4.417,13.631,111280,2.685,27.262,16342,16611,107761
1986,18,88150,107469,1865679,1838255,13264,12.481,10866,10.225,298759,108216,190543,5.887,16.252,243347,81276,162071,4.421,13.238,55412,3.014,26.476,7739,7910,48979
1986,19,53648,64391,867737,862287,6505,10.043,7266,11.218,137736,53835,83901,6.243,15.973,126968,47250,79718,5.480,14.725,10768,1.249,29.449,5183,5280,27688
1986,20,49628,58629,828590,819357,7148,12.197,7099,12.113,137189,48958,88231,5.975,16.744,119179,42890,76289,5.235,14.545,18010,2.198,29.091,5238,5341,26644
1986,21,56221,66912,1058316,1041587,8772,13.241,7444,11.237,172962,61971,110991,5.950,16.606,139341,47594,91747,4.569,13.378,33621,3.228,26.756,5463,5519,28529
1986,22,70224,84698,1242510,1254611,11173,13.148,11731,13.805,223097,87000,136097,6.934,17.782,247466,81757,165709,6.517,19.725,-24369,-1.942,35.564,8836,8958,51192
1986,23,23459,26887,367850,359406,4062,15.474,2790,10.628,65479,22931,42548,6.380,18.219,48273,17679,30594,4.919,13.431,17206,4.787,26.863,1967,2013,11119
1986,24,74630,89860,1610110,1569138,13154,15.015,8646,9.869,316106,116199,199907,7.405,20.145,234316,71729,162587,4.571,14.933,81790,5.212,29.866,5947,6049,41469
1986,25,114559,133944,2691403,2655089,17606,13.377,12943,9.834,454974,150906,304068,5.684,17.136,382136,114805,267331,4.324,14.393,72838,2.743,28.785,9131,9306,67009
1986,26,140957,170808,3121126,3037685,21709,12.879,17213,10.212,543926,181873,362053,5.987,17.906,376601,128096,248505,4.217,12.398,167325,5.508,24.795,12325,12517,74295
1986,27,77111,91745,1598505,1592857,11452,12.572,10147,11.139,259455,90388,169067,5.675,16.289,247186,85443,161743,5.364,15.518,12269,0.770,31.037,7138,7280,53803
1986,28,38947,46479,676911,662755,6042,13.102,5314,11.523,128681,42808,85873,6.459,19.416,100044,33709,66335,5.086,15.095,28637,4.321,30.190,3722,3774,19511
1986,29,89892,107872,1805131,1771109,14779,13.880,11982,11.254,324637,121182,203455,6.842,18.330,256013,92218,163795,5.207,14.455,68624,3.875,28.910,8572,8789,53751
1986,30,19077,21773,202972,204523,2874,13.177,2950,13.525,34753,14158,20595,6.922,16.992,37774,13921,23853,6.807,18.469,-3021,-1.477,33.984,2157,2176,9847
1986,31,32610,37987,501472,499774,4074,10.685,4360,11.435,77544,28959,48585,5.794,15.516,74016,24207,49809,4.844,14.810,3528,0.706,29.620,3166,3207,15715
1986,32,19371,22480,407313,399255,3792,17.139,3083,13.934,80952,30483,50469,7.635,20.276,64854,27714,37140,6.941,16.244,16098,4.032,32.488,2174,2203,14801
1986,33,24014,27041,425245,416106,4759,18.278,2751,10.566,85376,33230,52146,7.986,20.518,66081,26180,39901,6.292,15.881,19295,4.637,31.762,2034,2056,12391
1986,34,153536,175224,2984737,2950502,23246,13.462,18162,10.518,524982,173578,351404,5.883,17.793,455332,139282,316050,4.721,15.432,69650,2.361,30.865,12968,13119,73933
1986,35,26333,30869,385836,385828,4780,15.643,4155,13.598,76141,33368,42773,8.648,19.734,76023,25440,50583,6.594,19.704,118,0.031,39.408,2955,2996,16334
1986,36,342545,388941,6591480,6500426,49771,12.917,42518,11.035,1119782,372756,747026,5.734,17.226,939270,328398,610872,5.052,14.449,180512,2.777,28.899,31495,31878,181933
1986,37,109100,133249,2325626,2286605,18792,14.377,13714,10.492,375826,133571,242255,5.841,16.436,299499,100681,198818,4.403,13.098,76327,3.338,26.196,9593,9767,54493
1986,38,14419,16681,181359,181951,1769,10.586,1827,10.934,27372,10355,17017,5.691,15.044,28331,8960,19371,4.924,15.571,-959,-0.527,30.087,1320,1349,6144
1986,39,167003,208911,3792561,3738863,24342,11.774,20009,9.678,596437,195722,400715,5.235,15.952,488428,152325,336103,4.074,13.064,108009,2.889,26.127,13765,14025,86431
1986,40,58192,69186,952108,963405,9388,13.457,10547,15.118,161934,71268,90666,7.398,16.809,184717,66134,118583,6.865,19.173,-22783,-2.365,33.617,7894,8004,40554
1986,41,56404,66008,858949,846269,9808,15.067,7980,12.259,161238,60797,100441,7.184,19.053,135763,51523,84240,6.088,16.043,25475,3.010,32.085,5766,5831,32828
1986,42,191670,232165,4153672,4098516,28561,12.490,21588,9.440,671650,236646,435004,5.774,16.388,559652,177206,382446,4.324,13.655,111998,2.733,27.310,14919,15222,93078
1986,44,20439,22677,377534,367421,2988,13.426,2146,9.642,62216,20186,42030,5.494,16.933,42376,14833,27543,4.037,11.533,19840,5.400,23.067,1544,1557,9122
1986,45,53456,64898,1080549,1058247,9245,14.504,6934,10.878,198840,77161,121679,7.291,18.790,153375,51457,101918,4.862,14.493,45465,4.296,28.987,4812,4896,27559
1986,46,15037,17111,187323,187653,1839,10.751,1828,10.687,29055,10330,18725,5.505,15.483,29794,9529,20265,5.078,15.877,-739,-0.394,30.967,1275,1282,6165
1986,47,76766,93191,1627937,1593943,12978,14.109,10564,11.485,296434,102456,193978,6.428,18.598,227294,80229,147065,5.033,14.260,69140,4.338,28.520,7484,7638,48934
1986,48,285057,357634,5660135,5671183,53788,15.132,49419,13.903,1093546,436772,656774,7.702,19.283,1116009,382729,733280,6.749,19.679,-22463,-0.396,38.565,35925,36641,232563
1986,49,25836,30906,487231,483174,4616,15.024,4251,13.836,96417,40640,55777,8.411,19.955,88232,32042,56190,6.632,18.261,8185,1.694,36.522,3004,3055,20236
1986,50,13718,15238,191883,186882,2309,15.449,1725,11.542,34622,13565,21057,7.259,18.526,24929,8962,15967,4.796,13.339,9693,5.187,26.679,1275,1283,6124
1986,51,95002,117512,2000121,1937565,16955,14.777,11404,9.939,371577,142769,228808,7.368,19.178,245866,81118,164748,4.187,12.689,125711,6.488,25.379,7910,8022,44344
1986,53,87209,103149,1407978,1375949,15549,15.281,12764,12.544,285944,100817,185127,7.327,20.782,221522,83084,138438,6.038,16.100,64422,4.682,32.199,8938,9085,49564
1986,54,27215,32318,440989,438035,3970,12.321,3778,11.725,74832,29592,45240,6.756,17.084,68777,24635,44142,5.624,15.701,6055,1.382,31.403,2631,2670,12276
1986,55,85858,100564,1647805,1640917,11322,11.284,10874,10.837,245338,84232,161106,5.133,14.951,231376,93339,138037,5.688,14.100,13962,0.851,28.201,7337,7456,49625
1986,56,11528,13254,135500,137543,1685,12.579,1967,14.685,25027,10045,14982,7.303,18.196,29094,10570,18524,7.685,21.153,-4067,-2.957,36.392,1408,1423,6861
1987,01,60936,74690,1203369,1194711,10756,14.577,8948,12.127,221312,85344,135968,7.143,18.524,204056,73253,130803,6.131,17.080,17256,1.444,34.160,6165,6291,38934
1987,02,10002,11822,139800,142567,1912,15.799,2472,20.426,32405,15351,17054,10.768,22.730,38306,15582,22724,10.930,26.869,-5901,-4.139,45.459,1715,1756,9619
1987,04,60565,74215,1169581,1157068,13143,18.064,10232,14.063,263409,122797,140612,10.613,22.765,237768,96645,141123,8.353,20.549,25641,2.216,41.098,7146,7225,51878
1987,05,39904,46564,685023,678634,6423,13.846,6072,13.089,121252,44531,76721,6.562,17.867,107959,38855,69104,5.725,15.908,13293,1.959,31.817,4359,4413,24343
1987,06,504402,609002,10022764,9862761,95776,15.970,77209,12.874,2178089,857582,1320507,8.695,22.084,1860747,690729,1170018,7.003,18.866,317342,3.218,37.733,53106,54120,370136
1987,08,70190,83558,1202559,1211658,13154,15.780,12757,15.304,240357,111205,129152,9.178,19.837,259649,103572,156077,8.548,21.429,-19292,-1.592,39.674,8874,9066,57086
1987,09,69428,79946,1516726,1479007,11258,14.362,8143,10.388,276177,115831,160346,7.832,18.673,202989,69369,133620,4.690,13.725,73188,4.948,27.449,5844,5887,39627
1987,10,12493,14527,280436,291506,2194,15.422,1593,11.197,55530,19025,36505,6.526,19.049,75897,14597,S,5.007,26.036,-20367,-6.987,38.099,1086,1095,6967
1987,11,14321,16773,397515,389933,2153,12.898,1992,11.934,72827,27484,45343,7.048,18.677,57108,22323,34785,5.725,14.646,15719,4.031,29.291,1323,1343,12432
1987,12,242559,293623,4131889,4053040,51427,17.882,39363,13.687,927685,421274,506411,10.394,22.889,768838,304743,464095,7.519,18.969,158847,3.919,37.939,28619,28992,185512
1987,13,105718,131636,2332744,2292520,20327,15.705,15915,12.296,471298,204899,266399,8.938,20.558,390758,142490,248268,6.215,17.045,80540,3.513,34.090,10754,10931,74635
1987,15,19878,24241,366945,355965,3399,14.216,2737,11.447,79645,31144,48501,8.749,22.374,58125,22877,35248,6.427,16.329,21520,6.046,32.658,1755,1808,12473
1987,16,18737,22007,258974,264106,3018,13.734,2953,13.438,48820,20301,28519,7.687,18.485,59577,19166,40411,7.257,22.558,-10757,-4.073,36.970,1972,2006,12181
1987,17,191935,229530,4208631,4210829,28871,12.676,25338,11.125,697868,258440,439428,6.138,16.573,703426,237829,465597,5.648,16.705,-5558,-0.132,33.146,17374,17674,110207
1987,18,89663,109763,1932619,1901888,13916,12.815,11574,10.658,338513,128049,210464,6.733,17.799,277954,103553,174401,5.445,14.615,60559,3.184,29.229,7932,8168,55596
1987,19,53392,64353,883573,875391,7059,10.966,7092,11.018,145541,56491,89050,6.453,16.626,128483,49433,79050,5.647,14.677,17058,1.949,29.354,4793,4860,25882
1987,20,49313,58503,799386,802521,7136,12.185,7258,12.393,142513,63765,78748,7.946,17.758,149563,50776,98787,6.327,18.637,-7050,-0.878,35.516,4992,5080,26651
1987,21,57037,68115,1057358,1078095,8958,13.268,7760,11.494,183907,70897,113010,6.576,17.059,224190,64387,159803,5.972,20.795,-40283,-3.736,34.117,5449,5553,35612
1987,22,67063,81533,1181058,1215369,10155,12.218,13314,16.019,210157,92874,117283,7.642,17.292,278260,109718,168542,9.028,22.895,-68103,-5.603,34.583,9254,9404,59893
1987,23,24773,28450,390950,379229,4557,16.472,2986,10.794,75199,31047,44152,8.187,19.829,52156,22952,29204,6.052,13.753,23043,6.076,27.506,2163,2190,15182
1987,24,77247,93690,1693297,1655397,13670,14.896,9825,10.706,340949,134231,206718,8.109,20.596,264984,95416,169568,5.764,16.007,75965,4.589,32.015,6744,6848,50788
1987,25,118132,138594,2765625,2739316,19113,14.025,14485,10.629,484515,183741,300774,6.708,17.687,436371,137250,299121,5.010,15.930,48144,1.758,31.860,10172,10313,76404
1987,26,143508,174792,3167218,3148736,22533,13.040,18560,10.740,532460,192188,340272,6.104,16.910,495309,165201,330108,5.247,15.730,37151,1.180,31.461,12787,12970,83515
1987,27,78136,93465,1656070,1629548,11889,12.839,10166,10.978,294323,111479,182844,6.841,18.062,240887,86874,154013,5.331,14.782,53436,3.279,29.565,6905,7030,47269
1987,28,39010,46731,677981,679112,6168,13.232,5934,12.730,118247,47572,70675,7.005,17.412,120922,41985,78937,6.182,17.806,-2675,-0.394,34.824,4061,4112,22163
1987,29,91486,110370,1851610,1829994,15259,13.981,12805,11.732,344812,135201,209611,7.388,18.842,301699,109633,192066,5.991,16.486,43113,2.356,32.973,8801,8956,57821
1987,30,19030,21791,205445,204299,2987,13.714,2967,13.622,41500,17771,23729,8.699,20.313,39453,15849,23604,7.758,19.311,2047,1.002,38.623,2098,2116,9033
1987,31,32521,38080,514999,508964,4204,11.053,4115,10.819,87234,31796,55438,6.247,17.140,75516,29731,45785,5.841,14.837,11718,2.302,29.674,2889,2929,16370
1987,32,20243,23521,442455,426286,4196,18.242,3158,13.729,102448,38801,63647,9.102,24.033,70069,26949,43120,6.322,16.437,32379,7.596,32.874,2122,2150,15767
1987,33,25689,29066,445881,435571,5175,18.447,3151,11.232,89891,36062,53829,8.279,20.638,69242,25078,44164,5.758,15.897,20649,4.741,31.794,2272,2305,16006
1987,34,158334,181181,3115104,3056544,25413,14.263,19411,10.894,627549,239403,388146,7.832,20.531,508890,172806,336084,5.654,16.649,118659,3.882,33.298,13787,13929,87520
1987,35,26346,30997,392042,389304,4537,14.666,4415,14.271,83957,36845,47112,9.464,21.566,78637,29504,49133,7.579,20.199,5320,1.367,40.399,2985,3040,16824
1987,36,346958,395291,6807155,6705141,52241,13.324,45835,11.690,1252493,477306,775187,7.119,18.680,1044402,356572,687830,5.318,15.576,208091,3.103,31.152,34119,34426,205792
1987,37,111871,138015,2424185,2377913,19430,14.324,14692,10.831,430724,162342,268382,6.827,18.114,339213,127682,211531,5.369,14.265,91511,3.848,28.530,10182,10301,59185
1987,38,14435,16740,180103,180910,1920,11.495,1845,11.046,28320,10818,17502,5.980,15.654,29728,10332,19396,5.711,16.432,-1408,-0.778,31.308,1255,1270,6263
1987,39,169812,213828,3914277,3871222,26261,12.425,21329,10.091,666614,246320,420294,6.363,17.220,580751,216413,364338,5.590,15.002,85863,2.218,30.004,14080,14342,95232
1987,40,56062,67181,874521,937666,8825,12.940,10857,15.920,157250,72705,84545,7.754,16.770,286392,77055,209337,8.218,30.543,-129142,-13.773,33.541,7550,7698,44828
1987,41,57416,67624,889151,874244,10230,15.308,8639,12.927,175452,66758,108694,7.636,20.069,145408,59498,85910,6.806,16.632,30044,3.437,33.265,6140,6197,35845
1987,42,196202,238631,4282508,4227946,29823,12.669,23353,9.921,726366,266702,459664,6.308,17.180,617604,213046,404558,5.039,14.608,108762,2.572,29.215,15869,16123,108011
1987,44,21227,23648,394282,386166,3376,14.571,2419,10.440,69781,26209,43572,6.787,18.070,53640,20250,33390,5.244,13.890,16141,4.180,27.781,1778,1806,12412
1987,45,54938,67161,1127505,1105750,9784,14.817,7528,11.400,212585,86013,126572,7.779,19.225,168945,62389,106556,5.642,15.279,43640,3.947,30.558,5170,5257,30731
1987,46,15140,17233,194410,191185,2001,11.652,1881,10.953,33927,14163,19764,7.408,17.746,27690,9151,18539,4.786,14.483,6237,3.262,28.967,1317,1322,5799
1987,47,78612,96252,1683070,1656043,14024,14.804,10976,11.587,321525,126807,194718,7.657,19.415,268359,103870,164489,6.272,16.205,53166,3.210,32.410,7642,7724,51472
1987,48,277905,352097,5427873,5539610,50952,14.360,56394,15.894,1044167,466671,577496,8.424,18.849,1263811,487255,776556,8.796,22.814,-219644,-3.965,37.698,39178,40151,257813
1987,49,26208,31391,498689,493394,4776,15.334,4287,13.764,100567,39300,61267,7.965,20.383,90022,35216,54806,7.138,18.245,10545,2.137,36.491,2889,2970,19670
1987,50,14485,16132,206860,199604,2508,15.988,1618,10.314,41002,17024,23978,8.529,20.542,26302,10634,15668,5.328,13.177,14700,7.365,26.354,1168,1176,6194
1987,51,98309,122729,2116240,2061637,18169,15.126,12952,10.783,413355,162932,250423,7.903,20.050,304073,107825,196248,5.230,14.749,109282,5.301,29.498,8864,8997,54936
1987,53,89070,105812,1453726,1418254,15982,15.298,13305,12.735,303814,114659,189155,8.085,21.422,232396,89684,142712,6.324,16.386,71418,5.036,32.772,9227,9380,50903
1987,54,27342,32711,447759,446934,4237,13.033,3836,11.799,76976,31760,45216,7.106,17.223,75328,25096,50232,5.615,16.854,1648,0.369,33.709,2639,2658,13432
1987,55,87955,104120,1747779,1698408,13552,13.245,9954,9.728,310789,138605,172184,8.161,18.299,213393,70064,143329,4.125,12.564,97396,5.735,25.129,6958,7052,41403
1987,56,11079,12744,126399,131970,1571,12.078,2097,16.122,20043,8850,11193,6.706,15.188,31352,11210,20142,8.494,23.757,-11309,-8.569,30.375,1415,1436,6579
1988,01,62232,76602,1233903,1219946,10497,13.866,8697,11.488,216312,90021,126291,7.379,17.731,187945,67705,120240,5.550,15.406,28367,2.325,30.812,6003,6103,36428
1988,02,10011,11869,137015,138265,1952,16.470,1917,16.175,30517,12416,18101,8.980,22.071,33001,14067,18934,10.174,23.868,-2484,-1.797,44.143,1227,1257,7199
1988,04,62096,76540,1196441,1178895,12718,16.859,10510,13.932,260126,113598,146528,9.636,22.065,225915,86707,139208,7.355,19.163,34211,2.902,38.327,7372,7491,50345
1988,05,40141,47181,704276,695775,6257,13.344,5674,12.101,124069,43201,80868,6.209,17.832,106518,40300,66218,5.792,15.309,17551,2.523,30.619,4000,4048,23655
1988,06,517133,627297,10394671,10220837,94159,15.217,77099,12.460,2192566,814423,1378143,7.968,21.452,1845403,680374,1165029,6.657,18.055,347163,3.397,36.111,53282,54414,374611
1988,08,70349,84222,1202152,1201412,12782,15.228,12211,14.548,227886,92419,135467,7.693,18.968,226123,92244,133879,7.678,18.821,1763,0.147,37.643,8662,8782,50874
1988,09,71838,82984,1535321,1521952,11323,13.891,8384,10.285,265023,106370,158653,6.989,17.413,238625,89941,148684,5.910,15.679,26398,1.734,31.358,5929,5987,42870
1988,10,12996,15142,295167,288008,2195,14.790,1594,10.740,55547,19753,35794,6.859,19.287,40954,14079,26875,4.888,14.220,14593,5.067,28.440,1062,1082,7264
1988,11,14468,17226,380617,386970,2362,13.886,1931,11.352,62225,22322,39903,5.768,16.080,75109,19891,55218,5.140,19.410,-12884,-3.329,32.160,1293,1303,12332
1988,12,251811,306230,4331799,4236206,52665,17.548,40443,13.476,940078,399809,540269,9.438,22.192,748525,299693,448832,7.075,17.670,191553,4.522,35.339,29760,30295,190787
1988,13,109041,136542,2418399,2380304,20807,15.508,16068,11.976,464617,194155,270462,8.157,19.519,389056,147913,241143,6.214,16.345,75561,3.174,32.690,11071,11244,81670
1988,15,20489,25106,384353,375389,3508,14.219,2638,10.693,71936,29653,42283,7.899,19.163,54292,19602,34690,5.222,14.463,17644,4.700,28.926,1808,1859,10413
1988,16,19003,22409,269420,262827,3012,13.555,2635,11.858,55766,23612,32154,8.984,21.218,42691,17607,25084,6.699,16.243,13075,4.975,32.486,1817,1860,11887
1988,17,195535,234950,4362965,4287606,28726,12.362,23571,10.144,747443,263833,483610,6.153,17.433,596975,207938,389037,4.850,13.923,150468,3.509,27.847,16193,16466,105762
1988,18,91525,112572,2001812,1964431,13746,12.359,11051,9.936,333413,120560,212853,6.137,16.972,259079,87992,171087,4.479,13.189,74334,3.784,26.377,7626,7779,51128
1988,19,53840,65133,932019,908971,6774,10.457,6069,9.369,155274,50551,104723,5.561,17.082,109639,42234,67405,4.646,12.062,45635,5.021,24.124,4232,4312,25151
1988,20,50062,59839,822482,812508,7463,12.603,6215,10.496,140603,57751,82852,7.108,17.305,121210,45265,75945,5.571,14.918,19393,2.387,29.836,4388,4474,27905
1988,21,57929,69674,1098339,1076763,9049,13.129,7548,10.951,195683,75192,120491,6.983,18.173,152530,56410,96120,5.239,14.166,43153,4.008,28.331,5397,5479,31167
1988,22,66021,81014,1189444,1182319,10316,12.688,10897,13.403,220698,85817,134881,7.258,18.667,207059,79117,127942,6.692,17.513,13639,1.154,35.026,7538,7700,45970
1988,23,25973,29908,416043,404619,4559,15.615,3136,10.741,76469,24627,51842,6.086,18.899,53676,18476,35200,4.566,13.266,22793,5.633,26.532,2273,2288,11055
1988,24,80062,97729,1747904,1720278,14123,14.746,10216,10.667,334550,134952,199598,7.845,19.447,278116,88628,189488,5.152,16.167,56434,3.281,32.334,7031,7173,50525
1988,25,121866,143295,2822120,2795977,19153,13.578,14675,10.404,476260,167098,309162,5.976,17.034,423416,140922,282494,5.040,15.144,52844,1.890,30.288,10111,10296,71551
1988,26,147056,179481,3198823,3186438,22634,12.767,18251,10.294,515587,195913,319674,6.148,16.181,493885,167217,326668,5.248,15.500,21702,0.681,30.999,12242,12540,85626
1988,27,79644,95858,1708439,1684453,11958,12.621,9734,10.274,290399,110125,180274,6.538,17.240,242998,87363,155635,5.186,14.426,47401,2.814,28.852,6743,6872,48256
1988,28,39172,47199,701952,691361,6119,13.020,5713,12.156,123285,51544,71741,7.455,17.832,101932,39002,62930,5.641,14.744,21353,3.089,29.487,3910,3964,22967
1988,29,93097,112966,1872065,1856630,14881,13.316,12453,11.143,315744,115684,200060,6.231,17.006,284246,101060,183186,5.443,15.310,31498,1.697,30.620,8692,8833,51893
1988,30,19091,21928,205931,206404,2793,12.767,2689,12.292,37859,14855,23004,7.197,18.342,38864,15502,23362,7.511,18.829,-1005,-0.487,36.684,1864,1880,9004
1988,31,32932,38820,539913,528252,4338,11.273,3662,9.516,92144,31816,60328,6.023,17.443,68942,24841,44101,4.702,13.051,23202,4.392,26.102,2562,2598,13849
1988,32,21155,24737,469616,457711,4311,17.859,3115,12.904,111952,40942,71010,8.945,24.459,88769,37237,51532,8.135,19.394,23183,5.065,38.788,2167,2190,17294
1988,33,26844,30468,467882,457955,4895,16.433,3534,11.864,90949,34356,56593,7.502,19.860,71048,26127,44921,5.705,15.514,19901,4.346,31.028,2616,2637,15967
1988,34,162771,187073,3178275,3158883,25597,13.891,19992,10.849,558735,206613,352122,6.541,17.688,520508,168159,352349,5.323,16.478,38227,1.210,32.955,14412,14572,86272
1988,35,26510,31391,397620,395233,4567,14.632,4208,13.482,79703,31439,48264,7.955,20.166,74866,30236,44630,7.650,18.942,4837,1.224,37.885,2904,2957,18568
1988,36,352610,403294,6872280,6844491,52930,13.248,45414,11.367,1170979,387065,783914,5.655,17.108,1112461,357990,754471,5.230,16.253,58518,0.855,32.507,33706,34088,196579
1988,37,115456,143297,2548193,2491904,19987,14.199,14913,10.595,452592,180782,271810,7.255,18.163,338707,116359,222348,4.669,13.592,113885,4.570,27.185,10066,10260,59292
1988,38,14633,16952,186501,183685,1873,11.106,1699,10.074,30123,11782,18341,6.414,16.399,24516,9094,15422,4.951,13.347,5607,3.053,26.694,1116,1130,4997
1988,39,173355,219017,4007865,3952584,26007,12.008,21145,9.763,674038,257667,416371,6.519,17.053,565644,200744,364900,5.079,14.311,108394,2.742,28.621,13886,14362,107816
1988,40,55486,66940,889152,882255,8771,13.068,9126,13.597,172246,67723,104523,7.676,19.523,158938,68211,90727,7.731,18.015,13308,1.508,36.030,6454,6652,41092
1988,41,58555,69209,931988,910984,9768,14.265,8302,12.124,189460,70473,118987,7.736,20.797,146784,61852,84932,6.790,16.113,42676,4.685,32.225,5837,5967,35971
1988,42,201481,245876,4382278,4333276,29971,12.362,23115,9.534,723803,256563,467240,5.921,16.703,626032,225032,401000,5.193,14.447,97771,2.256,28.894,15922,16300,124520
1988,44,21961,24429,404008,400360,3351,13.930,2606,10.833,67688,24587,43101,6.141,16.907,59758,21582,38176,5.391,14.926,7930,1.981,29.852,1875,1893,11521
1988,45,56654,69570,1197921,1164924,9845,14.390,7532,11.010,235082,96151,138931,8.254,20.180,168430,66197,102233,5.683,14.458,66652,5.722,28.917,5264,5370,31109
1988,46,15326,17493,201116,198142,1957,11.266,1713,9.861,33373,13159,20214,6.641,16.843,27401,10426,16975,5.262,13.829,5972,3.014,27.658,1178,1203,6146
1988,47,80427,99346,1781346,1741251,14148,14.457,11176,11.420,356554,151054,205500,8.675,20.477,277204,108788,168416,6.248,15.920,79350,4.557,31.840,7585,7717,51603
1988,48,275464,351628,5513023,5481816,50470,14.335,51352,14.586,1132053,473230,658823,8.633,20.651,1069757,420488,649269,7.671,19.515,62296,1.136,39.029,35738,36801,227196
1988,49,26360,31840,513820,506654,4777,15.099,4373,13.822,107648,48779,58869,9.628,21.247,93222,41238,51984,8.139,18.400,14426,2.847,36.799,3009,3163,24655
1988,50,15167,16899,211242,208969,2496,15.106,1744,10.555,37443,15498,21945,7.416,17.918,33015,11977,21038,5.731,15.799,4428,2.119,31.598,1271,1284,7238
1988,51,102468,128392,2209346,2161932,18686,14.872,13193,10.500,416798,168845,247953,7.810,19.279,322665,113292,209373,5.240,14.925,94133,4.354,29.850,8980,9148,55218
1988,53,91515,109044,1518445,1486989,16075,14.953,13000,12.092,315939,111520,204419,7.500,21.247,253099,99803,153296,6.712,17.021,62840,4.226,34.042,8673,8884,51556
1988,54,28000,33504,465137,461785,4217,12.730,3463,10.454,77752,30796,46956,6.669,16.837,70716,24928,45788,5.398,15.314,7036,1.524,30.627,2384,2426,14160
1988,55,89468,106439,1828002,1788829,12002,11.394,9801,9.304,299187,107838,191349,6.028,16.725,221405,78704,142701,4.400,12.377,77782,4.348,24.754,6791,6908,42850
1988,56,11121,12784,123681,123948,1637,12.823,1601,12.541,23169,8835,14334,7.128,18.693,23694,10010,13684,8.076,19.116,-525,-0.424,37.385,1051,1064,5446
1989,01,63369,78414,1303017,1267717,10530,13.582,8755,11.293,238253,90994,147259,7.178,18.794,167999,59999,108000,4.733,13.252,70254,5.542,26.504,6194,6328,36238
1989,02,10319,12300,145195,141155,1946,16.092,1532,12.668,32287,12440,19847,8.813,22.874,24337,8721,15616,6.178,17.241,7950,5.632,34.483,1036,1058,5011
1989,04,62717,77554,1230963,1212497,12060,15.651,11061,14.355,256305,102797,153508,8.478,21.139,219559,88837,130722,7.327,18.108,36746,3.031,36.216,7697,7869,52385
1989,05,40533,47912,724379,713263,6025,12.670,5311,11.168,123011,46192,76819,6.476,17.246,101087,40125,60962,5.626,14.172,21924,3.074,28.345,3933,4012,25290
1989,06,528215,643670,10801203,10592762,94356,14.845,78203,12.304,2146287,772010,1374277,7.288,20.262,1733795,632900,1100895,5.975,16.368,412492,3.894,32.735,54447,55794,367276
1989,08,70857,84793,1229787,1215605,12111,14.330,11556,13.673,231159,88062,143097,7.244,19.016,202906,89236,113670,7.341,16.692,28253,2.324,33.384,8010,8250,51403
1989,09,72982,84511,1516546,1526311,10732,12.812,9237,11.027,231477,86626,144851,5.676,15.166,250227,105231,144996,6.894,16.394,-18750,-1.228,30.332,6681,6762,39428
1989,10,13588,15920,305985,300979,2337,15.044,1566,10.081,52736,19982,32754,6.639,17.521,42538,12383,30155,4.114,14.133,10198,3.388,28.266,1062,1088,7065
1989,11,14498,17531,390546,385716,2243,12.900,1957,11.255,64943,20599,44344,5.340,16.837,55354,23264,32090,6.031,14.351,9589,2.486,28.702,1292,1300,10653
1989,12,258849,315495,4535623,4440598,50891,16.368,41745,13.426,954570,377730,576840,8.506,21.496,768527,315988,452539,7.116,17.307,186043,4.190,34.614,30160,30878,200423
1989,13,111732,140427,2493392,2451423,20659,14.915,16831,12.151,489814,195712,294102,7.984,19.981,408041,146764,261277,5.987,16.645,81773,3.336,33.290,11568,11838,79394
1989,15,20944,25818,409046,396609,3324,13.052,2622,10.296,75190,29113,46077,7.340,18.958,50146,19156,30990,4.830,12.644,25044,6.315,25.287,1871,1901,12180
1989,16,19397,22912,292418,281018,3003,13.246,2520,11.116,61316,23670,37646,8.423,21.819,38381,14892,23489,5.299,13.658,22935,8.161,27.316,1714,1757,9745
1989,17,198788,239816,4509534,4438690,28931,12.186,24133,10.165,743362,272957,470405,6.149,16.747,602393,208041,394352,4.687,13.571,140969,3.176,27.143,16412,16863,108697
1989,18,93408,115390,2106843,2056541,13615,11.942,10858,9.524,343044,119239,223805,5.798,16.681,243318,88216,155102,4.290,11.831,99726,4.849,23.663,7715,7919,50393
1989,19,54334,65922,990036,961853,6676,10.186,5908,9.015,162169,60819,101350,6.323,16.860,107225,40804,66421,4.242,11.148,54944,5.712,22.296,4208,4297,25576
1989,20,50231,60259,868257,843159,6985,11.632,6564,10.931,167315,75500,91815,8.954,19.844,116429,43758,72671,5.190,13.809,50886,6.035,27.617,4761,4859,27038
1989,21,59027,71264,1148109,1122841,8999,12.767,7441,10.557,197588,68964,128624,6.142,17.597,147375,57393,89982,5.111,13.125,50213,4.472,26.250,5363,5458,32218
1989,22,65234,80308,1219660,1203763,9366,11.610,10099,12.518,223047,78497,144550,6.521,18.529,191914,77574,114340,6.444,15.943,31133,2.586,31.886,6992,7187,47847
1989,23,26833,30958,435334,425339,4445,14.602,3412,11.208,79127,29503,49624,6.936,18.603,59482,23371,36111,5.495,13.985,19645,4.619,27.969,2555,2612,14437
1989,24,82579,101086,1794408,1771509,13789,13.869,10463,10.524,320688,121264,199424,6.845,18.103,274705,98346,176359,5.552,15.507,45983,2.596,31.014,7189,7319,53439
1989,25,123371,145886,2875261,2848872,17966,12.423,15423,10.665,486061,171922,314139,6.035,17.062,435230,142131,293099,4.989,15.277,50831,1.784,30.555,11320,11491,78944
1989,26,151008,184963,3336708,3269684,22934,12.584,17505,9.605,547559,178205,369354,5.450,16.747,414165,141938,272227,4.341,12.667,133394,4.080,25.334,12335,12718,76632
1989,27,81151,98019,1772415,1738884,11693,12.060,9575,9.875,292292,99090,193202,5.698,16.809,225712,89496,136216,5.147,12.980,66580,3.829,25.961,6580,6750,45380
1989,28,39505,47874,717764,710020,6087,12.805,5413,11.387,116466,43268,73198,6.094,16.403,101117,36772,64345,5.179,14.241,15349,2.162,28.483,3809,3875,21633
1989,29,95091,115673,1938574,1905041,14791,12.934,12159,10.632,332335,108874,223461,5.715,17.445,267488,95486,172002,5.012,14.041,64847,3.404,28.082,8586,8816,57449
1989,30,19125,21999,212650,209338,2627,11.957,2568,11.689,37270,12497,24773,5.970,17.804,30622,12007,18615,5.736,14.628,6648,3.176,29.256,1789,1803,7854
1989,31,33259,39383,564621,552274,4358,11.143,3811,9.744,95849,35432,60417,6.416,17.355,71254,29512,41742,5.344,12.902,24595,4.453,25.804,2634,2706,16746
1989,32,22339,26154,508387,488800,4431,17.411,3022,11.874,116219,38548,77671,7.886,23.776,77478,31990,45488,6.545,15.851,38741,7.926,31.701,2090,2134,18376
1989,33,27145,30958,472868,470891,4329,14.091,3855,12.548,77926,30108,47818,6.394,16.549,74200,26026,48174,5.527,15.757,3726,0.791,31.515,2991,3026,16893
1989,34,164968,190179,3247547,3216248,24195,12.825,21154,11.213,567437,201593,365844,6.268,17.643,504692,166442,338250,5.175,15.692,62745,1.951,31.384,15340,15564,89924
1989,35,26831,31942,405874,401721,4547,14.354,4018,12.684,76776,30336,46440,7.552,19.112,68276,26570,41706,6.614,16.996,8500,2.116,33.992,2804,2869,16208
1989,36,356828,409418,6953085,6911866,52572,12.936,46567,11.458,1118191,390769,727422,5.654,16.178,1037966,367936,670030,5.323,15.017,80225,1.161,30.034,34602,35205,207362
1989,37,118684,147369,2625141,2587386,19291,13.270,15298,10.523,423225,159708,263517,6.173,16.357,350276,121900,228376,4.711,13.538,72949,2.819,27.076,10319,10564,61037
1989,38,14707,17105,190353,188401,1747,10.258,1598,9.383,28551,11005,17546,5.841,15.154,24876,8859,16017,4.702,13.204,3675,1.951,26.408,1157,1165,4996
1989,39,176448,223628,4160238,4092376,25656,11.589,21183,9.568,682611,251835,430776,6.154,16.680,545410,202285,343125,4.943,13.327,137201,3.353,26.655,14197,14739,98222
1989,40,55596,67216,915657,902698,8577,12.784,8324,12.407,163831,59855,103976,6.631,18.149,138242,55916,82326,6.194,15.314,25589,2.835,30.629,5911,6022,32909
1989,41,60098,71249,977160,954446,9884,14.072,7868,11.201,193307,68150,125157,7.140,20.253,147134,63028,84106,6.604,15.416,46173,4.838,30.831,5597,5738,32113
1989,42,205979,251714,4499713,4444055,28912,11.618,23196,9.321,696540,235511,461029,5.299,15.674,586035,213314,372721,4.800,13.187,110505,2.487,26.374,16100,16535,108493
1989,44,22392,24985,402411,403549,3249,13.141,2726,11.026,63758,24092,39666,5.970,15.799,66298,25979,40319,6.438,16.429,-2540,-0.629,31.599,2099,2115,16235
1989,45,57990,71419,1243030,1218891,9473,13.435,7658,10.861,211022,76864,134158,6.306,17.313,163359,58686,104673,4.815,13.402,47663,3.910,26.805,5316,5407,31333
1989,46,15538,17812,209349,205177,1942,11.000,1626,9.210,33314,9448,23866,4.605,16.237,24944,9621,15323,4.689,12.157,8370,4.079,24.315,1170,1182,5457
1989,47,82200,102213,1830854,1807133,13911,13.800,11091,11.003,322359,121820,200539,6.741,17.838,273177,107881,165296,5.970,15.117,49182,2.722,30.233,7720,7957,57102
1989,48,275345,352352,5650433,5576236,48432,13.757,47830,13.586,1114608,434710,679898,7.796,19.989,970290,407729,562561,7.312,17.400,144318,2.588,34.801,32780,34122,233860
1989,49,26562,32189,543706,528411,4539,14.175,4205,13.132,116201,45147,71054,8.544,21.991,86027,35486,50541,6.716,16.280,30174,5.710,32.561,2887,2959,20295
1989,50,15739,17573,220453,215810,2481,14.388,1822,10.566,35159,12603,22556,5.840,16.292,26004,9704,16300,4.497,12.049,9155,4.242,24.099,1406,1422,7172
1989,51,105559,133131,2296382,2256165,18660,14.268,13966,10.679,401749,156907,244842,6.955,17.807,322769,118854,203915,5.268,14.306,78980,3.501,28.612,9672,9939,57747
1989,53,94030,112443,1628361,1574799,16207,14.632,12856,11.606,333414,119107,214307,7.563,21.172,225133,82943,142190,5.267,14.296,108281,6.876,28.592,8852,9003,51556
1989,54,28339,34032,474715,470272,3956,11.712,3449,10.211,74441,29534,44907,6.280,15.829,65738,23761,41977,5.053,13.979,8703,1.851,27.957,2468,2511,14124
1989,55,91006,108785,1902274,1864518,12110,11.252,9796,9.102,290867,89914,200953,4.822,15.600,214863,73204,141659,3.926,11.524,76004,4.076,23.048,6839,7032,39134
1989,56,11162,12838,126787,125609,1578,12.316,1527,11.918,22565,7773,14792,6.188,17.965,20191,7605,12586,6.055,16.075,2374,1.890,32.149,1027,1038,4684
1990,01,64305,79776,1356147,1331096,9986,12.625,8628,10.908,225819,74954,150865,5.631,16.965,175537,58942,116595,4.428,13.187,50282,3.777,26.375,6319,6458,39434
1990,02,10612,12664,158120,151828,1871,14.991,1504,12.051,35438,10857,24581,7.151,23.341,22841,9404,13437,6.194,15.044,12597,8.297,30.088,1047,1082,6707
1990,04,63628,78756,1256814,1243599,11753,15.037,10564,13.516,245602,99481,146121,7.999,19.749,220112,77570,142542,6.238,17.700,25490,2.050,35.399,7471,7680,47971
1990,05,41360,48995,747870,735619,6163,12.718,5088,10.500,122728,44634,78094,6.068,16.684,97776,32473,65303,4.414,13.292,24952,3.392,26.583,3785,3843,21581
1990,06,541644,660984,11262202,11052832,94188,14.438,76972,11.799,2172358,784039,1388319,7.094,19.654,1754353,637015,1117338,5.763,15.872,418005,3.782,31.745,55117,56398,383728
1990,08,72371,86577,1270684,1250466,11992,13.995,10210,11.916,234479,91891,142588,7.349,18.751,194107,75433,118674,6.032,15.523,40372,3.229,31.046,7244,7404,44790
1990,09,72301,84185,1488364,1502217,9310,11.037,9641,11.430,208275,72512,135763,4.827,13.865,236665,84216,152449,5.606,15.754,-28390,-1.890,27.729,7078,7187,41206
1990,10,14078,16538,315905,311942,2255,13.889,1651,10.169,48552,15232,33320,4.883,15.564,40461,13422,27039,4.303,12.971,8091,2.594,25.941,1156,1166,6859
1990,11,14270,17381,400390,399077,2007,11.496,2162,12.384,57942,20457,37485,5.126,14.519,55452,18226,37226,4.567,13.895,2490,0.624,27.790,1485,1506,9657
1990,12,265749,324743,4667814,4614052,50885,15.895,41678,13.019,907405,372837,534568,8.080,19.666,797307,296306,501001,6.422,17.280,110098,2.386,34.560,31330,32078,194548
1990,13,113388,143022,2553084,2523174,19444,13.719,16853,11.891,455305,167688,287617,6.646,18.045,396499,140201,256298,5.557,15.714,58806,2.331,31.429,11878,12169,77053
1990,15,21582,26655,431219,419748,3415,13.015,2582,9.841,76417,29824,46593,7.105,18.205,52840,20238,32602,4.821,12.589,23577,5.617,25.177,1788,1836,11656
1990,16,20477,24101,308020,300283,3404,14.480,2217,9.431,57840,19816,38024,6.599,19.262,42720,14359,28361,4.782,14.227,15120,5.035,28.453,1579,1605,9383
1990,17,202697,244895,4643195,4586634,27988,11.547,22984,9.482,695991,236323,459668,5.152,15.174,583280,190345,392935,4.150,12.717,112711,2.457,25.434,16307,16624,104146
1990,18,95144,117944,2153144,2131289,13302,11.400,10774,9.234,309298,105878,203420,4.968,14.512,265289,81112,184177,3.806,12.447,44009,2.065,24.895,7808,7996,48652
1990,19,55074,67049,1021934,1006219,6659,10.014,5559,8.360,144672,46483,98189,4.620,14.378,112809,33777,79032,3.357,11.211,31863,3.167,22.422,4077,4179,23065
1990,20,50164,60336,893914,881358,6581,10.913,6520,10.812,137917,47309,90608,5.368,15.648,113502,40334,73168,4.576,12.878,24415,2.770,25.756,4737,4844,24793
1990,21,59909,72511,1189344,1170826,8684,12.079,7443,10.353,191295,69512,121783,5.937,16.338,153947,52360,101587,4.472,13.149,37348,3.190,26.297,5477,5571,31876
1990,22,65683,81042,1276661,1247877,9578,11.870,8870,10.993,232962,80424,152538,6.445,18.669,175393,65267,110126,5.230,14.055,57569,4.613,28.111,6340,6489,41725
1990,23,26367,30578,422027,428400,3482,11.315,3870,12.576,60368,24333,36035,5.680,14.092,73216,23201,50015,5.416,17.091,-12848,-2.999,28.183,2953,2997,16584
1990,24,84690,103927,1838386,1816494,13300,12.975,10463,10.207,313551,109361,204190,6.020,17.261,270799,90757,180042,4.996,14.908,42752,2.354,29.816,7376,7525,53427
1990,25,120470,143629,2781435,2835252,15100,10.430,17388,12.011,367228,130401,236827,4.599,12.952,475458,140236,335222,4.946,16.770,-108230,-3.817,25.904,12878,13105,81307
1990,26,153829,188999,3390319,3365968,21866,11.693,17879,9.561,515130,193137,321993,5.738,15.304,466871,137147,329724,4.075,13.870,48259,1.434,27.741,12891,13253,78122
1990,27,82883,100094,1827772,1801637,11351,11.458,9292,9.380,277105,89542,187563,4.970,15.381,223977,77347,146630,4.293,12.432,53128,2.949,24.864,6529,6670,42580
1990,28,39987,48503,738688,728208,5993,12.436,5371,11.145,116177,41916,74261,5.756,15.954,95961,33672,62289,4.624,13.178,20216,2.776,26.355,3900,3986,20838
1990,29,96697,117574,1986255,1962693,14029,12.028,12159,10.424,307784,108990,198794,5.553,15.682,260211,84778,175433,4.319,13.258,47573,2.424,26.516,8601,8822,51177
1990,30,19520,22429,223353,218296,2590,11.655,2178,9.801,38162,11986,26176,5.491,17.482,28052,9886,18166,4.529,12.850,10110,4.631,25.701,1562,1579,6383
1990,31,33607,39877,588268,576410,4059,10.242,3569,9.005,87768,31436,56332,5.454,15.227,64181,20154,44027,3.496,11.135,23587,4.092,22.269,2534,2578,13480
1990,32,23422,27459,547988,528066,4463,16.646,3166,11.809,115315,36123,79192,6.841,21.837,75149,26655,48494,5.048,14.231,40166,7.606,28.462,2280,2306,19082
1990,33,26181,30142,453260,462894,3650,11.947,4471,14.634,65334,26752,38582,5.779,14.114,84404,28496,55908,6.156,18.234,-19070,-4.120,28.228,3457,3511,19124
1990,34,165007,191480,3256102,3251373,22875,11.987,21574,11.305,518217,195673,322544,6.018,15.938,508638,158204,350434,4.866,15.644,9579,0.295,31.288,15780,15961,90170
1990,35,27446,32601,421657,414044,4408,13.656,3764,11.661,76401,29297,47104,7.076,18.452,60959,23093,37866,5.577,14.723,15442,3.730,29.446,2620,2675,14945
1990,36,356311,411407,6989618,6975525,49146,11.974,47224,11.506,1041206,355933,685273,5.103,14.927,1011832,340035,671797,4.875,14.505,29374,0.421,29.011,35850,36347,204246
1990,37,121691,151375,2707567,2666821,19010,12.726,15014,10.051,421577,148818,272759,5.580,15.808,341267,113147,228120,4.243,12.797,80310,3.011,25.594,10668,10935,63251
1990,38,14735,17172,196523,193476,1645,9.596,1587,9.257,27784,8164,19620,4.220,14.360,21661,7734,13927,3.997,11.196,6123,3.165,22.391,1176,1188,5093
1990,39,178212,226924,4248513,4209622,24096,10.696,20818,9.241,606757,212106,394651,5.039,14.414,529494,162806,366688,3.867,12.578,77263,1.835,25.156,14628,14991,96520
1990,40,56252,67960,938993,927636,8363,12.373,7620,11.274,159415,59046,100369,6.365,17.185,137288,49744,87544,5.362,14.800,22127,2.385,29.600,5505,5632,30312
1990,41,61249,72670,1018365,997553,9477,13.169,8064,11.206,185461,64913,120548,6.507,18.592,143748,53589,90159,5.372,14.410,41713,4.182,28.820,5735,5864,34705
1990,42,209270,256450,4599499,4555966,27512,10.827,22843,8.989,653819,207169,446650,4.547,14.351,566039,175938,390101,3.862,12.424,87780,1.927,24.848,16392,16733,103413
1990,44,22153,24810,391527,397130,2737,10.994,2908,11.681,53272,21750,31522,5.477,13.414,64923,19372,45551,4.878,16.348,-11651,-2.934,26.829,2249,2266,12318
1990,45,59397,73297,1294064,1268523,9616,13.288,7755,10.716,218057,82522,135535,6.505,17.190,166648,56715,109933,4.471,13.137,51409,4.053,26.274,5565,5703,33285
1990,46,15945,18280,219202,214221,2114,11.711,1657,9.179,35974,12854,23120,6.000,16.793,26136,10459,15677,4.882,12.200,9838,4.592,24.401,1198,1213,5037
1990,47,83202,103833,1881051,1854606,12754,12.378,11159,10.830,300115,110625,189490,5.965,16.182,246938,83147,163791,4.483,13.315,53177,2.867,26.630,8001,8151,50227
1990,48,279668,358319,5876469,5768157,48935,13.771,43017,12.105,1138911,434758,704153,7.537,19.745,918794,361461,557333,6.266,15.929,220117,3.816,31.857,30186,31226,212952
1990,49,27104,32868,573494,559146,4326,13.298,3652,11.226,106950,36925,70025,6.604,19.127,78538,28955,49583,5.178,14.046,28412,5.081,28.092,2538,2608,17180
1990,50,15757,17638,215452,217777,2047,11.623,1994,11.322,29735,10248,19487,4.706,13.654,34436,11065,23371,5.081,15.813,-4701,-2.159,27.308,1543,1555,7070
1990,51,108042,136863,2353507,2325147,17880,13.244,14158,10.487,384627,145175,239452,6.244,16.542,328780,103160,225620,4.437,14.140,55847,2.402,28.280,9985,10183,58680
1990,53,98047,117115,1719114,1673675,16935,14.753,12285,10.702,330258,107499,222759,6.423,19.733,241205,97906,143299,5.850,14.412,89053,5.321,28.823,8582,8781,51567
1990,54,28628,34490,491711,483635,3956,11.544,3511,10.246,77240,27525,49715,5.691,15.971,61445,21768,39677,4.501,12.705,15795,3.266,25.410,2570,2613,13818
1990,55,92829,111217,1968295,1936160,11655,10.594,9261,8.418,276204,92851,183353,4.796,14.266,212654,66464,146190,3.433,10.983,63550,3.282,21.967,6651,6843,39391
1990,56,11296,13002,133301,130184,1551,12.007,1382,10.699,24549,8073,16476,6.201,18.857,18292,6788,11504,5.214,14.051,6257,4.806,28.102,956,970,4526
1991,01,64055,80297,1347991,1355081,9762,12.202,9169,11.461,208487,88394,120093,6.523,15.386,221975,79570,142405,5.872,16.381,-13488,-0.995,30.771,6313,6475,50123
1991,02,10817,13085,160858,160159,1909,14.832,1480,11.499,31589,11652,19937,7.275,19.724,30209,9092,21117,5.677,18.862,1380,0.862,37.724,984,1006,5856
1991,04,64194,80199,1253393,1254660,11928,15.015,10406,13.100,235617,109643,125974,8.739,18.779,238883,86809,152074,6.919,19.040,-3266,-0.260,37.559,7191,7397,55919
1991,05,41212,49400,757377,755430,5968,12.136,5524,11.233,115925,43597,72328,5.771,15.346,112535,36883,75652,4.882,14.897,3390,0.449,29.794,3955,4005,23228
1991,06,539337,666897,10818248,11036791,92040,13.871,85368,12.865,1803618,734833,1068785,6.658,16.342,2242409,758882,1483527,6.876,20.318,-438791,-3.976,32.684,60250,61697,487262
1991,08,73801,88879,1290618,1280283,12660,14.440,10251,11.692,226436,88859,137577,6.941,17.686,206393,79875,126518,6.239,16.121,20043,1.566,32.242,7132,7298,49564
1991,09,69636,82092,1429317,1456705,8432,10.148,10432,12.555,202027,71196,130831,4.887,13.869,255819,79256,176563,5.441,17.561,-53792,-3.693,27.738,7473,7605,46888
1991,10,14221,16988,316280,316001,2297,13.704,1843,10.996,47097,19526,27571,6.179,14.904,46874,12010,34864,3.801,14.833,223,0.071,29.667,1249,1286,7354
1991,11,14204,17334,383835,394440,2139,12.332,2160,12.454,48680,19363,29317,4.909,12.342,70085,21232,48853,5.383,17.768,-21405,-5.427,24.683,1291,1329,11945
1991,12,265272,327302,4582378,4625781,49165,15.087,46307,14.210,851745,380738,471007,8.231,18.413,937349,350523,586826,7.578,20.264,-85604,-1.851,36.826,33264,34148,225954
1991,13,112787,143856,2459979,2507821,19191,13.386,18206,12.699,402362,171082,231280,6.822,16.044,495872,187755,308117,7.487,19.773,-93510,-3.729,32.089,12389,12715,110915
1991,15,21892,27454,434700,432529,3608,13.340,2792,10.323,74881,32034,42847,7.406,17.312,70729,23562,47167,5.448,16.352,4152,0.960,32.705,1920,1971,14681
1991,16,20804,24682,311936,309844,3133,12.853,2521,10.342,56190,20902,35288,6.746,18.135,51643,20104,31539,6.488,16.667,4547,1.468,33.335,1729,1750,10236
1991,17,202501,247292,4582460,4612430,27961,11.367,25364,10.311,655310,256915,398395,5.570,14.207,716324,240266,476058,5.209,15.530,-61014,-1.323,28.415,17698,18102,146714
1991,18,95178,119467,2105637,2125013,13335,11.240,11679,9.844,287353,113015,174338,5.318,13.522,327030,101918,225112,4.796,15.390,-39677,-1.867,27.045,8276,8472,63889
1991,19,55168,67994,1028287,1025497,6770,10.033,5735,8.499,137393,46506,90887,4.535,13.398,131246,41096,90150,4.007,12.798,6147,0.599,25.597,4048,4128,23886
1991,20,49769,60571,889895,891717,6992,11.575,6667,11.037,135432,55571,79861,6.232,15.188,139025,48084,90941,5.392,15.591,-3593,-0.403,30.376,4651,4815,30823
1991,21,59478,73177,1187457,1188820,8556,11.751,7820,10.740,179908,72203,107705,6.074,15.133,182833,60406,122427,5.081,15.379,-2925,-0.246,30.267,5728,5827,38483
1991,22,65682,82048,1300778,1289984,9872,12.112,8786,10.780,228483,86634,141849,6.716,17.712,207256,77108,130148,5.977,16.067,21227,1.646,32.133,6181,6354,47395
1991,23,25558,30078,399912,410971,3351,11.053,3829,12.630,51131,20586,30545,5.009,12.442,73172,23941,49231,5.825,17.805,-22041,-5.363,24.883,2724,2754,14949
1991,24,83726,104170,1733956,1786791,12678,12.190,12345,11.870,248163,105038,143125,5.879,13.889,353325,117081,236244,6.553,19.774,-105162,-5.886,27.778,8508,8647,63814
1991,25,115010,139412,2584880,2684928,14453,10.218,18521,13.094,320978,123197,197781,4.588,11.955,520334,174554,345780,6.501,19.380,-199356,-7.425,23.910,12702,13108,106390
1991,26,153732,190655,3249268,3327679,21239,11.195,19373,10.211,432228,164952,267276,4.957,12.989,590199,190203,399996,5.716,17.736,-157971,-4.747,25.978,13651,14024,106697
1991,27,83465,101962,1801164,1812139,11939,11.828,9895,9.803,262066,100301,161765,5.535,14.462,284395,95969,188426,5.296,15.694,-22329,-1.232,28.923,6901,7087,57119
1991,28,39801,48808,741054,740202,5914,12.162,5551,11.416,113809,43662,70147,5.899,15.375,112226,36141,76085,4.883,15.162,1583,0.214,30.323,3890,3940,22827
1991,29,96032,118296,1940958,1957296,14109,11.973,13207,11.207,279589,114002,165587,5.824,14.284,312400,109385,203015,5.589,15.961,-32811,-1.676,28.569,9242,9508,64803
1991,30,19654,22802,224802,223707,2693,11.921,2270,10.048,36581,14068,22513,6.289,16.352,34278,11384,22894,5.089,15.323,2303,1.029,30.646,1638,1668,7996
1991,31,33621,40438,589058,587427,4286,10.681,3665,9.133,83596,28872,54724,4.915,14.231,80554,28654,51900,4.878,13.713,3042,0.518,27.426,2607,2667,19257
1991,32,24139,28666,538902,539086,4613,16.447,3378,12.043,96062,38150,57912,7.077,17.819,95761,28992,66769,5.378,17.764,301,0.056,35.527,2382,2419,19352
1991,33,24945,29187,427489,444303,3445,11.623,4348,14.670,55850,24938,30912,5.613,12.570,89354,33441,55913,7.527,20.111,-33504,-7.541,25.141,3148,3201,20463
1991,34,160722,188249,3078968,3161018,21265,11.206,24281,12.796,443086,164889,278197,5.216,14.017,605977,190966,415011,6.041,19.170,-162891,-5.153,28.034,16890,17151,110473
1991,35,27687,33188,428748,425797,4559,13.870,3923,11.935,80816,33973,46843,7.979,18.980,74969,28694,46275,6.739,17.607,5847,1.373,35.213,2699,2768,17581
1991,36,349469,408009,6665889,6831359,47335,11.559,50340,12.293,913289,369784,543505,5.413,13.369,1247156,387061,860095,5.666,18.256,-333867,-4.887,26.738,37304,37903,251879
1991,37,120586,151911,2603345,2651878,17960,11.851,17230,11.369,351412,146627,204785,5.529,13.251,449673,145625,304048,5.491,16.957,-98261,-3.705,26.503,12025,12338,82783
1991,38,14619,17246,200086,198136,1755,10.206,1653,9.613,30756,12090,18666,6.102,15.523,26814,8829,17985,4.456,13.533,3942,1.990,27.066,1152,1176,5748
1991,39,177504,228395,4137627,4205788,23785,10.453,22071,9.700,535959,199514,336445,4.744,12.743,675517,211835,463682,5.037,16.062,-139558,-3.318,25.487,15118,15436,126767
1991,40,56717,69042,950808,944053,8674,12.672,7494,10.948,156430,63234,93196,6.698,16.570,141802,54913,86889,5.817,15.021,14628,1.549,30.041,5289,5423,34527
1991,41,61682,74127,1023178,1020908,9950,13.564,8412,11.467,176728,71740,104988,7.027,17.311,172462,62037,110425,6.077,16.893,4266,0.418,33.786,5894,6092,40426
1991,42,207581,256926,4503315,4554543,26030,10.147,25238,9.838,596037,221779,374258,4.869,13.087,699716,231218,468498,5.077,15.363,-103679,-2.276,26.173,17737,18225,135612
1991,44,21255,23971,364931,378140,2442,10.017,3258,13.364,49862,21574,28288,5.705,13.186,76537,23474,53063,6.208,20.240,-26675,-7.054,26.372,2302,2338,15062
1991,45,59463,74366,1264615,1280454,9616,13.031,8468,11.475,189424,82202,107222,6.420,14.794,221406,75246,146160,5.877,17.291,-31982,-2.498,29.587,5855,6043,44477
1991,46,16103,18721,229861,223939,2133,11.538,1666,9.011,40293,16857,23436,7.527,17.993,28697,9452,19245,4.221,12.815,11596,5.178,25.629,1206,1217,6372
1991,47,82628,104574,1847375,1865128,12734,12.230,11834,11.365,277712,112833,164879,6.050,14.890,313071,102706,210365,5.507,16.785,-35359,-1.896,29.779,8274,8456,64298
1991,48,281329,363987,5933636,5902359,49929,13.834,43798,12.135,1104830,447540,657290,7.582,18.718,1044578,415016,629562,7.031,17.698,60252,1.021,35.395,29987,30959,246976
1991,49,27725,33862,586344,579759,4717,14.147,3678,11.031,105124,40813,64311,7.040,18.132,92513,33140,59373,5.716,15.957,12611,2.175,31.914,2517,2592,21457
1991,50,15394,17423,204656,209883,1859,10.605,2071,11.815,26641,11564,15077,5.510,12.693,37249,11874,25375,5.657,17.748,-10608,-5.054,25.387,1536,1544,8268
1991,51,106469,136843,2250487,2299313,16602,12.138,16462,12.036,328002,143911,184091,6.259,14.265,426887,131716,295171,5.728,18.566,-98885,-4.301,28.530,11174,11535,75719
1991,53,99835,120666,1736771,1728389,17005,14.310,13339,11.225,307463,123015,184448,7.117,17.789,290108,91093,199015,5.270,16.785,17355,1.004,33.570,9107,9285,59160
1991,54,28507,34756,487539,489036,3896,11.260,3582,10.353,70490,29121,41369,5.955,14.414,73336,22594,50742,4.620,14.996,-2846,-0.582,28.828,2468,2508,14399
1991,55,93014,112951,1950100,1958681,11946,10.666,10049,8.972,253819,90458,163361,4.618,12.959,271033,90194,180839,4.605,13.838,-17214,-0.879,25.917,7066,7257,58149
1991,56,11484,13333,137228,135798,1640,12.457,1305,9.912,23609,8013,15596,5.901,17.385,20518,7095,13423,5.225,15.109,3091,2.276,30.219,923,929,5127
1992,01,64662,81106,1362054,1358782,9465,11.732,8606,10.667,212274,72378,139896,5.327,15.622,204645,70499,134146,5.188,15.061,7629,0.561,30.122,5785,5931,38652
1992,02,10982,13358,163816,161412,1808,13.694,1498,11.346,34138,10653,23485,6.600,21.150,29224,9705,19519,6.013,18.105,4914,3.044,36.210,927,945,5322
1992,04,65036,80954,1268556,1259954,11193,13.898,10358,12.861,242772,93894,148878,7.452,19.268,225467,82283,143184,6.531,17.895,17305,1.373,35.790,6528,6702,42776
1992,05,41673,50045,779716,774056,5976,12.025,5282,10.628,126078,41327,84751,5.339,16.288,114830,35806,79024,4.626,14.835,11248,1.453,29.670,3579,3653,21923
1992,06,531518,658959,10446004,10625960,81536,12.306,88793,13.401,1790309,647072,1143237,6.090,16.848,2144359,805310,1339049,7.579,20.180,-354050,-3.332,33.697,58957,60426,442004
1992,08,75467,90604,1327739,1307667,12334,13.754,10477,11.683,249118,93970,155148,7.186,19.051,207771,83817,123954,6.410,15.889,41347,3.162,31.777,6768,6915,43647
1992,09,67974,80426,1396932,1408491,7925,9.757,9520,11.721,191026,62689,128337,4.451,13.562,214636,68524,146112,4.865,15.239,-23610,-1.676,27.125,6293,6429,36297
1992,10,14193,17066,306476,310436,2169,12.748,2067,12.148,46529,20640,25889,6.649,14.988,54612,21401,33211,6.894,17.592,-8083,-2.604,29.977,1257,1267,7626
1992,11,14040,17190,393895,387746,1816,10.531,1924,11.158,66837,35785,31052,9.229,17.237,56434,16626,39808,4.288,14.554,10403,2.683,29.109,1123,1131,8406
1992,12,269098,330910,4578315,4574395,48301,14.680,44516,13.530,868968,352689,516279,7.710,18.996,861505,351300,510205,7.680,18.833,7463,0.163,37.666,30450,31243,193364
1992,13,114426,145353,2508512,2487278,18989,13.136,17399,12.036,445921,163060,282861,6.556,17.928,402951,151921,251030,6.108,16.200,42970,1.728,32.401,11019,11420,78493
1992,15,21769,27501,445021,439353,3020,11.006,2896,10.554,75504,23498,52006,5.348,17.185,64193,20819,43374,4.739,14.611,11311,2.574,29.222,1877,1908,12142
1992,16,21492,25445,324324,317507,3293,13.148,2495,9.962,59371,20680,38691,6.513,18.699,45755,14763,30992,4.650,14.411,13616,4.288,28.821,1615,1655,8364
1992,17,202880,248400,4547126,4556375,26720,10.790,25201,10.176,683937,228751,455186,5.020,15.011,701828,239420,462408,5.255,15.403,-17891,-0.393,30.021,16286,16657,124949
1992,18,95768,120648,2154587,2138570,12736,10.615,11411,9.510,342158,119692,222466,5.597,15.999,312007,94688,217319,4.428,14.590,30151,1.410,29.179,7630,7793,49888
1992,19,55492,68520,1043191,1034976,6516,9.549,5948,8.717,153688,51322,102366,4.959,14.849,136628,45208,91420,4.368,13.201,17060,1.648,26.402,3920,4007,24802
1992,20,50056,61100,898465,893786,6668,10.967,6064,9.974,138505,50356,88149,5.634,15.496,129372,41879,87493,4.686,14.475,9133,1.022,28.949,3982,4053,24566
1992,21,59605,73525,1202706,1193741,8048,10.976,7642,10.423,175627,57615,118012,4.826,14.712,157829,51618,106211,4.324,13.221,17798,1.491,26.443,5242,5337,30005
1992,22,66239,82657,1305115,1299368,9341,11.350,8624,10.479,226692,74401,152291,5.726,17.446,214910,76874,138036,5.916,16.540,11782,0.907,33.079,5568,5712,40420
1992,23,25295,29856,393714,396121,3174,10.599,3353,11.197,55515,20118,35397,5.079,14.015,60471,22002,38469,5.554,15.266,-4956,-1.251,28.029,2219,2260,10916
1992,24,83819,104396,1711523,1726703,11890,11.405,11595,11.122,267233,94633,172600,5.481,15.476,297605,98675,198930,5.715,17.235,-30372,-1.759,30.953,7329,7517,49967
1992,25,112847,137082,2549702,2562108,13529,9.791,15734,11.386,366610,127769,238841,4.987,14.309,390534,129377,261157,5.050,15.243,-23924,-0.934,28.618,10037,10289,67851
1992,26,153455,190717,3276802,3260672,19674,10.324,19370,10.165,488119,147669,340450,4.529,14.970,454959,142109,312850,4.358,13.953,33160,1.017,27.906,12663,12974,75660
1992,27,84167,102981,1836426,1817185,11225,10.962,10063,9.827,281628,92020,189608,5.064,15.498,243097,82495,160602,4.540,13.378,38531,2.120,26.755,6487,6680,44298
1992,28,40023,49026,751688,745578,5455,11.155,5207,10.648,115943,33610,82333,4.508,15.551,103491,34717,68774,4.656,13.881,12452,1.670,27.761,3467,3534,19460
1992,29,96507,118766,1978242,1967658,13286,11.215,12697,10.717,291713,97171,194542,4.938,14.825,270918,89402,181516,4.544,13.769,20795,1.057,27.537,8217,8394,43286
1992,30,20095,23394,236159,230028,2931,12.697,2313,10.019,43799,13921,29878,6.052,19.041,31715,12692,19023,5.518,13.787,12084,5.253,27.575,1536,1575,7184
1992,31,33927,40758,593660,590487,4080,10.052,3742,9.219,81495,26649,54846,4.513,13.801,75049,22884,52165,3.875,12.710,6446,1.092,25.419,2460,2512,13608
1992,32,24470,29194,540884,539318,4319,14.938,3756,12.991,91637,36713,54924,6.807,16.991,88101,28181,59920,5.225,16.336,3536,0.656,32.671,2479,2505,16696
1992,33,24632,29038,422726,420748,3393,11.659,3522,12.102,68627,24328,44299,5.782,16.311,64665,21649,43016,5.145,15.369,3962,0.942,30.738,2410,2452,12749
1992,34,158964,186163,3036095,3055876,19780,10.571,21693,11.593,458604,139181,319423,4.555,15.007,498815,160601,338214,5.255,16.323,-40211,-1.316,30.015,14314,14482,80287
1992,35,27906,33561,438847,434196,4277,12.815,3907,11.706,83354,31331,52023,7.216,19.197,73947,26038,47909,5.997,17.031,9407,2.167,34.062,2504,2576,14200
1992,36,343831,401964,6544503,6603707,43154,10.660,48845,12.066,938286,311845,626441,4.722,14.208,1055296,374743,680553,5.675,15.980,-117010,-1.772,28.417,34282,34731,193866
1992,37,120939,152671,2642233,2621676,16818,11.047,15960,10.483,397063,134232,262831,5.120,15.145,356884,124723,232161,4.757,13.613,40179,1.533,27.226,10357,10567,55853
1992,38,14602,17313,207651,204315,1676,9.700,1607,9.301,30866,9713,21153,4.754,15.107,24247,7303,16944,3.574,11.867,6619,3.240,23.735,1064,1074,4460
1992,39,177200,228331,4125378,4127289,22229,9.740,22032,9.653,578093,193894,384199,4.698,14.007,582112,191337,390775,4.636,14.104,-4019,-0.097,28.013,13910,14301,104324
1992,40,57014,69511,956651,952240,8179,11.813,7628,11.017,158893,54640,104253,5.738,16.686,150797,55304,95493,5.808,15.836,8096,0.850,31.672,5258,5374,31370
1992,41,62712,75240,1030025,1024553,9400,12.593,8209,10.997,179453,66309,113144,6.472,17.515,168363,63187,105176,6.167,16.433,11090,1.082,32.866,5306,5397,31797
1992,42,205455,255147,4471192,4495317,23771,9.290,25242,9.865,622861,207856,415005,4.624,13.856,673831,206175,467656,4.586,14.990,-50970,-1.134,27.712,16574,16979,99905
1992,44,20790,23476,358627,361067,2411,10.165,2895,12.206,55231,21558,33673,5.971,15.297,59884,22239,37645,6.159,16.585,-4653,-1.289,30.593,1903,1937,11929
1992,45,59670,74647,1279277,1271316,8670,11.640,8347,11.206,198357,72672,125685,5.716,15.602,181873,57943,123930,4.558,14.306,16484,1.297,28.612,5515,5605,32623
1992,46,16233,18917,240495,235260,1996,10.613,1777,9.448,39426,12631,26795,5.369,16.759,28922,9420,19502,4.004,12.294,10504,4.465,24.587,1173,1185,5849
1992,47,83207,105313,1893984,1870612,12218,11.645,11428,10.892,311146,96635,214511,5.166,16.633,264867,97396,167471,5.207,14.159,46279,2.474,28.319,7338,7508,46859
1992,48,285519,368991,5992335,5970057,48439,13.224,43029,11.747,1116406,426227,690179,7.139,18.700,1072532,378707,693825,6.343,17.965,43874,0.735,35.930,27735,28631,199517
1992,49,28588,34813,617145,601476,4809,14.014,3813,11.112,120650,41730,78920,6.938,20.059,89371,34299,55072,5.702,14.859,31279,5.200,29.717,2464,2519,19644
1992,50,15261,17285,205422,205583,1755,10.116,1882,10.848,29599,9791,19808,4.763,14.398,29872,9508,20364,4.625,14.530,-273,-0.133,28.795,1287,1295,6402
1992,51,107037,137347,2265020,2256670,15885,11.593,15238,11.121,359586,127783,231803,5.662,15.934,344364,116688,227676,5.171,15.260,15222,0.675,30.520,9521,9813,56113
1992,53,102526,123825,1789493,1760783,16812,13.761,13502,11.052,344249,123979,220270,7.041,19.551,286855,113992,172863,6.474,16.291,57394,3.260,32.583,8718,8880,50740
1992,54,28582,34865,482545,484754,3659,10.520,3494,10.045,71826,24769,47057,5.110,14.817,76066,26885,49181,5.546,15.692,-4240,-0.875,29.634,2216,2262,12295
1992,55,93599,113820,1979436,1962458,10955,9.667,9968,8.796,266570,80608,185962,4.108,13.583,232556,69579,162977,3.546,11.850,34014,1.733,23.700,6573,6682,37781
1992,56,11616,13426,138326,137634,1542,11.531,1435,10.731,23551,7408,16143,5.382,17.111,22186,7163,15023,5.204,16.120,1365,0.992,32.239,850,878,3823
1993,01,66336,82762,1415067,1388559,9599,11.716,7941,9.692,224650,67204,157446,4.840,16.179,171029,57711,113318,4.156,12.317,53621,3.862,24.634,5365,5506,31792
1993,02,11297,13591,165374,164546,1724,12.796,1487,11.037,29491,8513,20978,5.174,17.923,27873,8447,19426,5.134,16.939,1618,0.983,33.879,889,926,4359
1993,04,67133,82559,1314484,1290946,11240,13.748,9631,11.780,247436,83897,163539,6.499,19.167,201646,76568,125078,5.931,15.620,45790,3.547,31.240,6216,6386,41220
1993,05,43087,51407,809289,794235,6313,12.445,4952,9.762,128621,39787,88834,5.009,16.194,99229,32377,66852,4.077,12.494,29392,3.701,24.987,3423,3479,17893
1993,06,526574,649101,10452006,10484838,75694,11.574,85464,13.068,1795942,576284,1219658,5.496,17.129,1869337,674582,1194755,6.434,17.829,-73395,-0.700,34.258,55680,57231,347386
1993,08,79408,94241,1396044,1362565,13122,14.197,9497,10.275,257801,84533,173268,6.204,18.920,191386,67172,124214,4.930,14.046,66415,4.874,28.092,6215,6348,33099
1993,09,68274,80421,1387122,1393453,7941,9.875,7934,9.866,198715,58191,140524,4.176,14.261,211803,57848,153955,4.151,15.200,-13088,-0.939,28.521,5208,5306,26632
1993,10,14628,17417,310100,308010,2079,12.055,1736,10.066,46285,14984,31301,4.865,15.027,42033,12275,29758,3.985,13.647,4252,1.380,27.293,1045,1063,5331
1993,11,14122,17086,392262,390140,1766,10.305,1869,10.906,55972,18591,37381,4.765,14.347,51616,17867,33749,4.580,13.230,4356,1.117,26.460,990,1010,6202
1993,12,278626,339349,4783638,4685887,49876,14.884,41385,12.350,950593,355808,594785,7.593,20.286,754689,298180,456509,6.363,16.106,195904,4.181,32.211,29041,29845,178150
1993,13,118505,149121,2605377,2556622,19354,13.145,15578,10.581,455355,157856,297499,6.174,17.811,358461,127370,231091,4.982,14.021,96894,3.790,28.042,10226,10497,66892
1993,15,21756,27363,432247,438588,2856,10.412,2989,10.897,61510,22790,38720,5.196,14.025,73503,23449,50054,5.346,16.759,-11993,-2.734,28.049,1957,2001,11159
1993,16,22342,26301,339191,331699,3353,12.960,2495,9.644,58420,20224,38196,6.097,17.612,43638,14113,29525,4.255,13.156,14782,4.456,26.312,1640,1672,8934
1993,17,206745,251788,4612339,4582881,26313,10.521,22935,9.170,685637,210977,474660,4.604,14.961,623743,188179,435564,4.106,13.610,61894,1.351,27.221,15223,15611,92010
1993,18,98018,122746,2216831,2186483,12575,10.334,10453,8.590,322192,92633,229559,4.237,14.736,262958,79363,183595,3.630,12.027,59234,2.709,24.053,7085,7276,43030
1993,19,56198,69122,1046736,1038194,6220,9.040,5591,8.126,136658,39901,96757,3.843,13.163,119765,34907,84858,3.362,11.536,16893,1.627,23.072,3785,3854,18128
1993,20,51080,62047,914154,906064,6557,10.650,5604,9.102,131466,40070,91396,4.422,14.510,115346,34373,80973,3.794,12.730,16120,1.779,25.461,3731,3813,21058
1993,21,60830,74739,1244235,1224138,8271,11.158,7049,9.509,191536,63951,127585,5.224,15.647,151683,48956,102727,3.999,12.391,39853,3.256,24.782,4823,4935,27003
1993,22,67921,84217,1326123,1315574,9291,11.136,7724,9.258,222155,71113,151042,5.405,16.887,201309,65270,136039,4.961,15.302,20846,1.585,30.604,5296,5397,38866
1993,23,25673,30087,408492,401106,3327,11.100,3101,10.346,64929,23036,41893,5.743,16.187,50561,17269,33292,4.305,12.605,14368,3.582,25.211,2003,2058,9341
1993,24,85535,105296,1716078,1713342,12138,11.578,11223,10.705,270541,92177,178364,5.380,15.790,264917,85247,179670,4.975,15.462,5624,0.328,30.924,6884,7093,43344
1993,25,113989,137810,2584394,2566132,14052,10.225,13296,9.675,395198,122086,273112,4.758,15.401,357865,116662,241203,4.546,13.946,37333,1.455,27.891,8648,9002,55227
1993,26,156451,193467,3373334,3328051,20083,10.456,17310,9.012,526461,162527,363934,4.884,15.819,436968,141692,295276,4.258,13.130,89493,2.689,26.260,11629,11987,67169
1993,27,86794,105591,1894603,1863847,11362,10.896,8732,8.374,285386,92066,193320,4.940,15.312,223541,71794,151747,3.852,11.994,61845,3.318,23.987,5741,5964,36462
1993,28,41062,50139,781106,764320,5860,11.819,4746,9.572,132108,46520,85588,6.086,17.284,98498,37626,60872,4.923,12.887,33610,4.397,25.774,3355,3395,23279
1993,29,98639,120604,2006629,1990653,13443,11.233,11581,9.677,293401,93041,200360,4.674,14.739,261830,82175,179655,4.128,13.153,31571,1.586,26.306,7837,8013,45875
1993,30,20517,23829,242339,239315,2718,11.510,2288,9.689,40204,12643,27561,5.283,16.800,33971,10938,23033,4.571,14.195,6233,2.605,28.390,1572,1592,7082
1993,31,34386,41212,615293,604538,3976,9.701,3523,8.596,89580,29014,60566,4.799,14.818,67520,20465,47055,3.385,11.169,22060,3.649,22.338,2404,2480,11809
1993,32,25275,29889,565076,553431,4433,15.006,3740,12.660,102257,36267,65990,6.553,18.477,78886,29558,49328,5.341,14.254,23371,4.223,28.508,2398,2439,16600
1993,33,24918,29318,432379,427287,3334,11.427,3050,10.454,67195,21909,45286,5.127,15.726,57056,17655,39401,4.132,13.353,10139,2.373,26.706,2050,2105,9434
1993,34,161567,188367,3067861,3046983,21096,11.267,18850,10.067,496329,153853,342476,5.049,16.289,456396,147451,308945,4.839,14.979,39933,1.311,29.957,12674,12942,69625
1993,35,28849,34371,456999,447437,4285,12.618,3461,10.192,84151,26523,57628,5.928,18.807,65216,22955,42261,5.130,14.575,18935,4.232,29.151,2298,2341,11886
1993,36,344725,402294,6481420,6499684,44578,11.086,44201,10.992,948310,322080,626230,4.955,14.590,984447,325816,658631,5.013,15.146,-36137,-0.556,29.180,31269,31865,174223
1993,37,123565,155306,2714126,2677335,16995,11.037,14340,9.313,406835,122883,283952,4.590,15.196,332782,107221,225561,4.005,12.430,74053,2.766,24.859,9560,9776,57409
1993,38,14870,17588,214180,210563,1681,9.634,1403,8.041,30970,9075,21895,4.310,14.708,23799,7625,16174,3.621,11.303,7171,3.406,22.605,957,969,4265
1993,39,180253,230433,4182157,4155177,22231,9.692,20114,8.769,588156,181987,406169,4.380,14.155,534758,165718,369040,3.988,12.870,53398,1.285,25.739,12783,13288,79729
1993,40,58433,70783,969855,963429,8198,11.687,6919,9.864,154784,53060,101724,5.507,16.066,142161,48082,94079,4.991,14.756,12623,1.310,29.511,4698,4783,27305
1993,41,64386,76666,1054491,1041847,9263,12.197,7823,10.301,177800,54734,123066,5.254,17.066,151848,48696,103152,4.674,14.575,25952,2.491,29.150,5113,5194,24046
1993,42,206067,255178,4504838,4489481,22833,8.949,22778,8.927,618438,192743,425695,4.293,13.775,588423,173954,414469,3.875,13.107,30015,0.669,26.213,15251,15673,91044
1993,44,21167,23837,366258,361920,2621,11.080,2258,9.545,54315,17469,36846,4.827,15.007,45814,15485,30329,4.279,12.659,8501,2.349,25.317,1531,1564,8336
1993,45,61037,76048,1304976,1292455,8837,11.728,7438,9.871,191424,60941,130483,4.715,14.811,166953,56941,110012,4.406,12.918,24471,1.893,25.835,5001,5108,26010
1993,46,16600,19253,247614,243735,1946,10.196,1611,8.441,37500,10966,26534,4.499,15.386,30166,8807,21359,3.613,12.377,7334,3.009,24.753,1084,1110,5286
1993,47,85593,107614,1944081,1919740,12463,11.708,10137,9.523,307246,100771,206475,5.249,16.005,257560,79917,177643,4.163,13.416,49686,2.588,26.833,6694,6922,42426
1993,48,293907,376148,6149075,6070001,47998,12.884,40790,10.949,1152917,402883,750034,6.637,18.994,998021,361024,636997,5.948,16.442,154896,2.552,32.884,26650,27567,180171
1993,49,29893,36105,651721,634362,4904,13.832,3604,10.165,116299,37339,78960,5.886,18.333,81259,31803,49456,5.013,12.810,35040,5.524,25.619,2421,2528,18989
1993,50,15561,17611,212763,208725,1943,11.138,1611,9.235,34860,13462,21398,6.450,16.701,27041,10865,16176,5.205,12.955,7819,3.746,25.911,1157,1183,4891
1993,51,109713,139670,2311311,2287762,15799,11.407,13454,9.714,361927,124166,237761,5.427,15.820,315489,102961,212528,4.501,13.790,46438,2.030,27.581,8566,8845,47952
1993,53,105889,126927,1814143,1802436,16625,13.260,13516,10.781,303009,96956,206053,5.379,16.811,279966,95067,184899,5.274,15.533,23043,1.278,31.065,8804,9069,46091
1993,54,29180,35431,495055,488812,3717,10.576,3145,8.949,76153,23759,52394,4.861,15.579,63651,20813,42838,4.258,13.022,12502,2.558,26.043,2099,2137,11012
1993,55,95770,116012,2035179,2006389,11375,9.898,9192,7.999,280800,81697,199103,4.072,13.995,223932,71864,152068,3.582,11.161,56868,2.834,22.322,6280,6458,36695
1993,56,12017,13977,141867,140099,1837,13.411,1279,9.337,25289,9750,15539,6.959,18.051,21687,7099,14588,5.067,15.480,3602,2.571,30.960,836,854,4032
1994,01,68215,84952,1450972,1436132,10342,12.327,8238,9.819,220244,78811,141433,5.488,15.336,191363,63093,128270,4.393,13.325,28881,2.011,26.650,5722,5862,36050
1994,02,11658,13957,173362,170331,1827,13.258,1473,10.689,33640,12101,21539,7.104,19.750,27788,8636,19152,5.070,16.314,5852,3.436,32.628,924,948,4305
1994,04,69841,86219,1415732,1367423,12848,15.214,9310,11.024,300404,114649,185755,8.384,21.969,202740,79661,123079,5.826,14.826,97664,7.142,29.653,6448,6613,41492
1994,05,44200,52903,837758,824143,6577,12.607,5107,9.790,134243,51436,82807,6.241,16.289,106459,40433,66026,4.906,12.918,27784,3.371,25.835,3671,3749,23789
1994,06,526641,649243,10429157,10430905,80501,12.392,81237,12.505,1809481,690128,1119353,6.616,17.347,1814047,658109,1155938,6.309,17.391,-4566,-0.044,34.695,53793,55595,358545
1994,08,83434,99072,1462537,1431236,14446,14.936,9738,10.068,266486,99033,167453,6.919,18.619,204450,74537,129913,5.208,14.285,62036,4.334,28.570,6868,7007,41451
1994,09,68665,81047,1372260,1379950,8136,10.071,7618,9.430,191717,60790,130927,4.405,13.893,207819,68304,139515,4.950,15.060,-16102,-1.167,27.786,5302,5407,31464
1994,10,14941,17838,313693,312168,2236,12.684,1817,10.307,48984,18014,30970,5.771,15.692,45648,13944,31704,4.467,14.623,3336,1.069,29.246,1141,1150,6002
1994,11,14269,17288,394072,392398,1838,10.689,1654,9.619,51005,17097,33908,4.357,12.998,47284,15162,32122,3.864,12.050,3721,0.948,24.100,1063,1097,6822
1994,12,285280,347814,4989881,4894173,50338,14.643,42230,12.285,953546,363832,589714,7.434,19.483,760850,293682,467168,6.001,15.546,192696,3.937,31.092,30989,31658,186355
1994,13,122163,153837,2721475,2666294,20617,13.601,16120,10.634,476962,178318,298644,6.688,17.889,366204,142225,223979,5.334,13.735,110758,4.154,27.469,11016,11252,74278
1994,15,21769,27386,426843,430275,2823,10.304,2843,10.377,61950,27518,34432,6.395,14.398,69129,23369,45760,5.431,16.066,-7179,-1.668,28.796,1933,2015,15046
1994,16,23656,27788,362213,351378,3919,14.474,2497,9.222,66744,22111,44633,6.293,18.995,45090,14835,30255,4.222,12.832,21654,6.163,25.665,1711,1747,9798
1994,17,210255,256453,4745178,4687837,27517,10.822,23165,9.110,708751,234761,473990,5.008,15.119,593159,204911,388248,4.371,12.653,115592,2.466,25.306,15919,16266,103379
1994,18,100129,125610,2279368,2254595,13270,10.680,10559,8.498,328830,103351,225479,4.584,14.585,278942,93627,185315,4.153,12.372,49888,2.213,24.744,7380,7654,48809
1994,19,56939,70183,1076417,1064175,6636,9.520,5688,8.160,144842,45455,99387,4.271,13.611,120805,40906,79899,3.844,11.352,24037,2.259,22.704,4020,4129,22039
1994,20,52163,63343,945204,930554,7042,11.224,5835,9.300,143853,48629,95224,5.226,15.459,114841,38630,76211,4.151,12.341,29012,3.118,24.682,4057,4214,22892
1994,21,61850,76203,1283107,1265687,8239,10.906,6918,9.158,193236,64946,128290,5.131,15.267,158106,51490,106616,4.068,12.492,35130,2.776,24.983,4894,4993,31933
1994,22,69381,86136,1381340,1354474,10023,11.761,8197,9.618,240190,89051,151139,6.575,17.733,186434,58867,127567,4.346,13.764,53756,3.969,27.529,5665,5887,35879
1994,23,26077,30635,417294,413404,3495,11.508,2964,9.760,59502,19004,40498,4.597,14.393,52026,18375,33651,4.445,12.585,7476,1.808,25.170,2108,2148,11990
1994,24,86906,106885,1742888,1732586,12164,11.459,10703,10.082,277110,94146,182964,5.434,15.994,256603,86294,170309,4.981,14.810,20507,1.184,29.621,7132,7332,44865
1994,25,115833,140234,2630887,2614736,14922,10.727,12663,9.103,388927,123277,265650,4.715,14.874,355755,113405,242350,4.337,13.606,33172,1.269,27.212,8540,8720,58302
1994,26,159504,197434,3501581,3445584,20956,10.714,17285,8.837,533883,177002,356881,5.137,15.495,422586,144371,278215,4.190,12.265,111297,3.230,24.529,12095,12500,74817
1994,27,89166,108740,1969300,1939275,11887,11.082,8932,8.327,285037,92447,192590,4.767,14.698,224832,73564,151268,3.793,11.594,60205,3.105,23.187,6144,6304,40748
1994,28,41698,50997,825677,805363,5980,11.814,5222,10.316,142229,53602,88627,6.656,17.660,101008,32997,68011,4.097,12.542,41221,5.118,25.084,3796,3880,19816
1994,29,100679,123273,2072716,2042860,14602,11.965,12131,9.940,321678,105637,216041,5.171,15.746,261935,92967,168968,4.551,12.822,59743,2.924,25.644,8528,8745,50353
1994,30,21233,24619,249046,246010,2970,12.246,2236,9.220,40368,15289,25079,6.215,16.409,34191,10840,23351,4.406,13.898,6177,2.511,27.796,1589,1609,7125
1994,31,34931,41980,634308,625925,4226,10.150,3541,8.504,89689,31231,58458,4.990,14.329,73122,25309,47813,4.043,11.682,16567,2.647,23.364,2511,2557,13334
1994,32,26720,31623,626804,600337,5142,16.709,3444,11.191,133745,45590,88155,7.594,22.278,79693,31794,47899,5.296,13.275,54052,9.004,26.549,2399,2447,20880
1994,33,25509,30028,454464,444755,3571,12.023,2919,9.828,73160,23071,50089,5.187,16.450,53804,18878,34926,4.245,12.097,19356,4.352,24.195,1986,2014,10759
1994,34,163321,190735,3092401,3084101,21473,11.322,19330,10.192,463773,154615,309158,5.013,15.038,447216,150591,296625,4.883,14.501,16557,0.537,29.001,13183,13429,74984
1994,35,29765,35543,480939,470744,4726,13.510,3605,10.305,88003,30547,57456,6.489,18.694,67597,23560,44037,5.005,14.360,20406,4.335,28.719,2515,2553,13990
1994,36,345065,404071,6561007,6532770,45216,11.209,43842,10.869,983725,338840,644885,5.187,15.058,928777,317927,610850,4.867,14.217,54948,0.841,28.434,31375,31938,177961
1994,37,127086,159760,2840096,2784898,18415,11.680,14225,9.022,431759,144045,287714,5.172,15.504,321775,105832,215943,3.800,11.554,109984,3.949,23.109,9798,10036,58669
1994,38,15133,17903,222315,218696,1666,9.382,1374,7.738,31661,9963,21698,4.556,14.477,24432,7276,17156,3.327,11.172,7229,3.306,22.343,986,1003,4396
1994,39,183292,234393,4323595,4263313,23307,10.018,19816,8.518,627781,202366,425415,4.747,14.725,507031,162039,344992,3.801,11.893,120750,2.832,23.786,13087,13503,77363
1994,40,59627,72310,1002651,987776,8574,11.981,7084,9.899,161210,57362,103848,5.807,16.321,131640,44707,86933,4.526,13.327,29570,2.994,26.654,5047,5126,26107
1994,41,67228,80148,1116124,1088022,10826,13.798,7446,9.490,196506,70771,125735,6.505,18.061,139991,47595,92396,4.374,12.867,56515,5.194,25.733,5200,5306,27635
1994,42,205834,256017,4542674,4531363,23389,9.145,22846,8.933,621403,206331,415072,4.553,13.713,598062,204539,393523,4.514,13.198,23341,0.515,26.397,15476,15840,106552
1994,44,21486,24194,370754,369247,2692,11.204,2357,9.810,56327,23587,32740,6.388,15.255,53006,18882,34124,5.114,14.355,3321,0.899,28.710,1669,1708,9482
1994,45,62385,77777,1350189,1327921,9220,11.981,7578,9.847,210698,77748,132950,5.855,15.867,166600,56756,109844,4.274,12.546,44098,3.321,25.092,5193,5313,33533
1994,46,17090,19877,258102,253105,2177,11.117,1587,8.104,38492,13150,25342,5.195,15.208,28610,9605,19005,3.795,11.304,9882,3.904,22.607,1134,1155,5865
1994,47,87626,110314,2015284,1981182,12825,11.763,10261,9.411,319580,117235,202345,5.917,16.131,252156,95943,156213,4.843,12.728,67424,3.403,25.455,7068,7222,46236
1994,48,301753,386268,6359100,6271176,50387,13.208,40816,10.699,1126160,411937,714223,6.569,17.958,947938,334889,613049,5.340,15.116,178222,2.842,30.232,27928,28789,185667
1994,49,31508,38088,693833,673389,5646,15.207,3724,10.030,126174,44103,82071,6.549,18.737,85507,32176,53331,4.778,12.698,40667,6.039,25.396,2639,2716,20516
1994,50,15772,17859,215529,214258,1801,10.149,1573,8.864,29383,9312,20071,4.346,13.714,26712,8998,17714,4.200,12.467,2671,1.247,24.934,1116,1136,4988
1994,51,112413,142869,2380791,2350754,16285,11.519,13288,9.399,366378,127329,239049,5.417,15.586,307096,101061,206035,4.299,13.064,59282,2.522,26.127,8766,8992,49525
1994,53,109115,130711,1881100,1862549,17374,13.478,13765,10.678,305840,108708,197132,5.837,16.421,269387,80380,189007,4.316,14.463,36453,1.957,28.927,9379,9582,46356
1994,54,29632,36101,508045,503223,3759,10.501,3149,8.797,73585,24778,48807,4.924,14.623,64119,19671,44448,3.909,12.742,9466,1.881,25.483,2224,2242,10662
1994,55,97358,118278,2099132,2072728,11593,9.887,9551,8.145,274803,86881,187922,4.192,13.258,221795,68645,153150,3.312,10.701,53008,2.557,21.401,6666,6840,38334
1994,56,12527,14586,150673,146680,1836,12.840,1263,8.832,27554,10899,16655,7.430,18.785,19491,5742,13749,3.915,13.288,8063,5.497,26.576,838,856,3573
1995,01,70164,87473,1517425,1481705,10643,12.346,8116,9.414,247373,86212,161161,5.818,16.695,175859,57453,118406,3.877,11.869,71514,4.826,23.737,5771,5910,35642
1995,02,12052,14379,176751,174939,1888,13.324,1470,10.374,30245,10214,20031,5.839,17.289,26586,8078,18508,4.618,15.197,3659,2.092,30.395,974,1002,4522
1995,04,72551,89498,1500898,1457988,13015,14.815,9720,11.064,292662,112336,180326,7.705,20.073,206130,79914,126216,5.481,14.138,86532,5.935,28.276,6657,6849,49012
1995,05,45421,54503,881068,858843,6733,12.538,5127,9.547,145785,49446,96339,5.757,16.975,101098,39865,61233,4.642,11.771,44687,5.203,23.543,3741,3792,22755
1995,06,531577,655758,10706609,10565631,82218,12.602,75577,11.584,1846880,646901,1199979,6.123,17.480,1567157,549026,1018131,5.196,14.833,279723,2.647,29.665,51356,52977,314967
1995,08,87274,103674,1542521,1500923,14934,14.734,10304,10.166,294947,111738,183209,7.445,19.651,211202,74008,137194,4.931,14.071,83745,5.580,28.143,7257,7365,44383
1995,09,69658,82249,1393762,1381673,8594,10.528,7360,9.016,200726,76964,123762,5.570,14.528,176618,55002,121616,3.981,12.783,24108,1.745,25.566,5028,5224,27469
1995,10,15413,18405,329284,321219,2347,12.951,1781,9.828,55729,18083,37646,5.629,17.349,39419,13703,25716,4.266,12.272,16310,5.078,24.543,1168,1192,6734
1995,11,14385,17478,393774,393936,1867,10.741,1676,9.642,53233,17244,35989,4.377,13.513,54215,16053,38162,4.075,13.762,-982,-0.249,27.026,1052,1078,6927
1995,12,291189,355640,5196149,5088582,50368,14.321,42485,12.080,1004428,416485,587943,8.185,19.739,787264,304195,483069,5.978,15.471,217164,4.268,30.942,31268,32119,202529
1995,13,126403,159593,2887599,2805985,21691,13.841,15925,10.162,532536,202557,329979,7.219,18.979,369170,136773,232397,4.874,13.157,163366,5.822,26.313,11013,11289,71435
1995,15,21870,27562,422427,423317,2877,10.474,2689,9.790,54499,21614,32885,5.106,12.874,56544,18400,38144,4.347,13.357,-2045,-0.483,25.749,1848,1892,8737
1995,16,24667,28882,374390,368133,3835,13.537,2729,9.633,63931,21787,42144,5.918,17.366,51384,19705,31679,5.353,13.958,12547,3.408,27.916,1901,1919,8661
1995,17,214368,261874,4889419,4812918,28771,11.103,23280,8.984,745332,258257,487075,5.366,15.486,591857,194803,397054,4.048,12.297,153475,3.189,24.595,15773,16162,101664
1995,18,102353,128816,2370266,2324100,14211,11.172,10988,8.638,356434,122046,234388,5.251,15.336,264175,86485,177690,3.721,11.367,92259,3.970,22.734,7740,7991,47387
1995,19,57687,71263,1118164,1097097,6884,9.734,5798,8.199,155992,48314,107678,4.404,14.219,114423,39866,74557,3.634,10.430,41569,3.789,20.859,4099,4210,24198
1995,20,53030,64571,975257,960311,6984,10.922,5736,8.970,140520,49514,91006,5.156,14.633,110410,36816,73594,3.834,11.497,30110,3.135,22.995,4089,4183,21947
1995,21,63158,78027,1340575,1311586,8736,11.329,6903,8.952,211759,72621,139138,5.537,16.145,152828,52825,100003,4.028,11.652,58931,4.493,23.304,4893,4995,29709
1995,22,70668,87804,1413120,1395560,9849,11.326,8165,9.389,241604,90642,150962,6.495,17.312,205854,78759,127095,5.644,14.751,35750,2.562,29.501,5679,5908,40787
1995,23,26725,31317,430939,424052,3641,11.755,2957,9.546,61962,20534,41428,4.842,14.612,47792,15818,31974,3.730,11.270,14170,3.342,22.541,2044,2087,9987
1995,24,89025,109370,1804954,1771996,13021,12.043,10514,9.725,292272,97366,194906,5.495,16.494,225932,82520,143412,4.657,12.750,66340,3.744,25.500,7171,7381,43981
1995,25,118314,143432,2699733,2663456,16004,11.285,12774,9.007,405163,133870,271293,5.026,15.212,331982,112406,219576,4.220,12.464,73181,2.748,24.929,8547,8988,62761
1995,26,163499,202336,3658535,3578166,22349,11.182,17425,8.718,584017,198699,385318,5.553,16.322,424871,141137,283734,3.944,11.874,159146,4.448,23.748,12094,12399,77654
1995,27,91245,111313,2043787,2005698,11847,10.768,9254,8.411,294303,98634,195669,4.918,14.673,217847,68126,149721,3.397,10.861,76456,3.812,21.723,6346,6535,39395
1995,28,42529,52097,857295,839819,6087,11.810,4976,9.654,141681,53727,87954,6.397,16.870,106818,37116,69702,4.420,12.719,34863,4.151,25.438,3588,3692,22031
1995,29,102637,125768,2141327,2105540,14690,11.798,12173,9.777,339461,108994,230467,5.177,16.122,268273,92188,176085,4.378,12.741,71188,3.381,25.483,8618,8839,50401
1995,30,21922,25416,259603,253792,3155,12.618,2331,9.323,42800,16413,26387,6.467,16.864,31238,11072,20166,4.363,12.309,11562,4.556,24.617,1659,1680,7564
1995,31,35344,42598,657660,645491,4096,9.686,3476,8.220,93353,29222,64131,4.527,14.462,69415,24217,45198,3.752,10.754,23938,3.708,21.508,2509,2561,15611
1995,32,28181,33387,665582,643943,5399,16.613,3624,11.151,124302,50653,73649,7.866,19.303,81406,26312,55094,4.086,12.642,42896,6.661,25.284,2610,2659,19387
1995,33,26362,31018,472745,462622,3789,12.416,2788,9.136,74006,27359,46647,5.914,15.997,53834,19249,34585,4.161,11.637,20172,4.360,23.273,1950,2039,11766
1995,34,167685,195607,3175184,3130576,23341,12.084,18439,9.546,500081,174125,325956,5.562,15.974,409794,142049,267745,4.537,13.090,90287,2.884,26.180,12935,13196,77766
1995,35,30571,36522,502455,490836,4755,13.198,3765,10.450,89694,33757,55937,6.877,18.274,66001,24732,41269,5.039,13.447,23693,4.827,26.893,2658,2713,15178
1995,36,349729,409607,6623511,6587308,47127,11.585,41491,10.200,970415,341293,629122,5.181,14.732,896300,279479,616821,4.243,13.606,74115,1.125,27.213,29935,30513,165817
1995,37,131563,165353,2964112,2901005,19521,12.010,13897,8.550,449588,149317,300271,5.147,15.498,321795,102867,218928,3.546,11.093,127793,4.405,22.185,9722,9990,56862
1995,38,15377,18171,230677,225955,1658,9.193,1388,7.696,34802,11312,23490,5.006,15.402,25510,9266,16244,4.101,11.290,9292,4.112,22.580,970,982,5145
1995,39,187015,239356,4495901,4407108,24714,10.434,19713,8.323,669233,222789,446444,5.055,15.185,492940,154287,338653,3.501,11.185,176293,4.000,22.370,13255,13705,81588
1995,40,60628,73568,1030759,1016550,8421,11.546,7156,9.811,160551,55126,105425,5.423,15.794,132058,46933,85125,4.617,12.991,28493,2.803,25.982,5226,5354,28510
1995,41,69315,82684,1170146,1142451,10788,13.251,8240,10.122,202685,70870,131815,6.203,17.741,148003,52028,95975,4.554,12.955,54682,4.786,25.910,5804,5953,32792
1995,42,208953,260144,4653033,4597702,25470,9.870,21317,8.260,641847,217090,424757,4.722,13.960,531488,186383,345105,4.054,11.560,110359,2.400,23.120,14539,15058,102482
1995,44,21690,24459,371356,367644,2589,10.646,2310,9.499,52415,17144,35271,4.663,14.257,45023,14593,30430,3.969,12.246,7392,2.011,24.493,1623,1644,7758
1995,45,64169,80062,1400057,1374905,9950,12.609,7644,9.687,217911,80847,137064,5.880,15.849,166276,58912,107364,4.285,12.094,51635,3.756,24.187,5398,5570,35014
1995,46,17433,20299,270358,264204,2053,10.220,1630,8.114,38819,11825,26994,4.476,14.693,26534,9911,16623,3.751,10.043,12285,4.650,20.086,1169,1192,5498
1995,47,90019,113463,2119516,2064945,13531,12.094,10373,9.271,351767,122735,229032,5.944,17.035,241706,80907,160799,3.918,11.705,110061,5.330,23.410,7167,7369,47215
1995,48,308918,395917,6660363,6506411,51346,13.130,41606,10.640,1231334,456357,774977,7.014,18.925,924880,328002,596878,5.041,14.215,306454,4.710,28.430,28724,29705,187222
1995,49,33128,40012,739241,716158,5867,15.026,3934,10.075,138341,52296,86045,7.302,19.317,92081,30554,61527,4.266,12.858,46260,6.459,25.715,2795,2867,19447
1995,50,16062,18183,218300,217459,1864,10.341,1547,8.583,31514,10508,21006,4.832,14.492,29514,10464,19050,4.812,13.572,2000,0.920,27.144,1118,1128,6384
1995,51,115850,146980,2474216,2429285,17478,12.060,13367,9.223,396124,142027,254097,5.846,16.306,305505,107779,197726,4.437,12.576,90619,3.730,25.152,9032,9302,53471
1995,53,111380,133488,1934739,1907175,17503,13.251,14713,11.138,314741,115403,199338,6.051,16.503,259966,91074,168892,4.775,13.631,54775,2.872,27.262,10133,10342,54695
1995,54,30323,36938,527757,518617,4000,10.954,3154,8.638,81073,27304,53769,5.265,15.633,62536,20931,41605,4.036,12.058,18537,3.574,24.116,2179,2204,11252
1995,55,99122,120559,2180066,2138181,11892,9.959,9594,8.035,298036,94997,203039,4.443,13.939,214988,64018,150970,2.994,10.055,83048,3.884,20.109,6814,7021,37798
1995,56,12902,14974,152941,157323,1772,11.990,1383,9.358,24701,8921,15780,5.671,15.701,32767,7039,25728,4.474,20.828,-8066,-5.127,31.402,948,960,4300
1996,01,71049,89037,1525167,1516310,10519,11.940,8637,9.804,230036,81280,148756,5.360,15.171,212058,71054,141004,4.686,13.985,17978,1.186,27.970,6274,6390,40499
1996,02,12232,14589,177563,176669,1838,12.728,1541,10.671,29511,8742,20769,4.948,16.704,28020,10102,17918,5.718,15.860,1491,0.844,31.720,1011,1031,5435
1996,04,74457,92254,1570493,1530030,13223,14.584,10053,11.088,295519,111093,184426,7.261,19.315,213827,78791,135036,5.150,13.975,81692,5.339,27.951,6982,7170,49912
1996,05,45815,55152,890373,883164,6434,11.758,5573,10.184,129287,43921,85366,4.973,14.639,114658,35237,79421,3.990,12.983,14629,1.656,25.965,4061,4175,23117
1996,06,536734,662455,10852695,10749435,83668,12.724,73852,11.231,1890203,662551,1227652,6.164,17.584,1683460,585952,1097508,5.451,15.661,206743,1.923,31.322,50497,52063,332262
1996,08,89456,106315,1578629,1556337,14694,14.024,11625,11.095,296116,118989,177127,7.645,19.026,252432,99104,153328,6.368,16.220,43684,2.807,32.439,7981,8118,48886
1996,09,69459,82338,1396372,1391725,8072,9.830,7624,9.285,198389,76657,121732,5.508,14.255,189876,61246,128630,4.401,13.643,8513,0.612,27.286,5166,5345,31924
1996,10,15605,18648,331226,329160,2203,11.932,1833,9.928,48557,18562,29995,5.639,14.752,44536,13755,30781,4.179,13.530,4021,1.222,27.060,1207,1242,7056
1996,11,14380,17508,364236,375050,1850,10.601,1735,9.942,46237,15908,30329,4.242,12.328,66659,15235,51424,4.062,17.773,-20422,-5.445,24.656,1085,1120,7196
1996,12,295067,360937,5299381,5233150,50038,13.990,43478,12.156,1011211,409501,601710,7.825,19.323,880864,334108,546756,6.384,16.832,130347,2.491,33.665,31653,32344,202794
1996,13,129654,164016,2958586,2912274,22379,13.858,17321,10.726,519020,199210,319810,6.840,17.822,427103,157046,270057,5.393,14.666,91917,3.156,29.331,11925,12184,80021
1996,15,21691,27295,414705,416644,2798,10.225,2939,10.740,60819,27689,33130,6.646,14.597,64568,20744,43824,4.979,15.497,-3749,-0.900,29.195,1903,2009,10525
1996,16,25343,29680,383281,377136,3990,13.653,3078,10.532,69879,24569,45310,6.515,18.529,58009,21221,36788,5.627,15.381,11870,3.147,30.763,2131,2156,11812
1996,17,215647,264330,4888796,4863712,28321,10.787,24746,9.426,707781,245944,461837,5.057,14.552,658890,193624,465266,3.981,13.547,48891,1.005,27.094,17022,17463,101683
1996,18,103088,130320,2376950,2366721,13704,10.594,11782,9.108,343313,129874,213439,5.488,14.506,322349,100535,221814,4.248,13.620,20964,0.886,27.240,8205,8446,54295
1996,19,57883,71757,1140058,1125646,6691,9.375,5916,8.289,153495,52714,100781,4.683,13.636,124389,36355,88034,3.230,11.050,29106,2.586,22.101,4185,4266,22649
1996,20,53346,65232,995214,980264,6951,10.736,5974,9.227,151359,55108,96251,5.622,15.441,121676,41782,79894,4.262,12.413,29683,3.028,24.825,4279,4387,25799
1996,21,63518,78966,1347049,1339880,8612,10.992,7372,9.410,197023,75367,121656,5.625,14.705,182664,58419,124245,4.360,13.633,14359,1.072,27.266,5235,5356,33151
1996,22,71690,89212,1442373,1422489,9722,11.003,8017,9.073,235320,79121,156199,5.562,16.543,195172,61513,133659,4.324,13.720,40148,2.822,27.441,5681,5807,36838
1996,23,27125,31805,431806,430001,3696,11.733,3088,9.803,58264,21592,36672,5.021,13.550,54665,18546,36119,4.313,12.713,3599,0.837,25.426,2158,2180,10872
1996,24,89384,110092,1802639,1795506,12275,11.212,11051,10.094,277247,105913,171334,5.899,15.441,264821,86909,177912,4.840,14.749,12426,0.692,29.498,7470,7646,47854
1996,25,119069,144648,2710847,2689693,15145,10.540,13235,9.211,387662,126009,261653,4.685,14.413,345325,125989,219336,4.684,12.839,42337,1.574,25.678,8763,9069,66694
1996,26,165358,205427,3658646,3639054,21924,10.778,17886,8.793,518535,177031,341504,4.865,14.249,481762,139707,342055,3.839,13.239,36773,1.011,26.477,12720,13062,83785
1996,27,92779,113289,2082603,2054860,12043,10.749,9541,8.516,295437,99887,195550,4.861,14.377,239421,73824,165597,3.593,11.651,56016,2.726,23.303,6606,6779,46437
1996,28,42940,52858,855173,851993,6125,11.690,5200,9.925,129895,53575,76320,6.288,15.246,122875,41979,80896,4.927,14.422,7020,0.824,28.844,3793,3858,24202
1996,29,103306,127191,2149077,2131444,14211,11.261,12216,9.680,321143,112422,208721,5.274,15.067,285839,90471,195368,4.245,13.411,35304,1.656,26.821,8870,9021,49632
1996,30,22424,25854,263124,260453,3129,12.229,2593,10.134,41407,15777,25630,6.058,15.898,35950,13068,22882,5.017,13.803,5457,2.095,27.606,1729,1752,8063
1996,31,35465,42855,672815,663470,4158,9.752,3726,8.738,93113,31264,61849,4.712,14.034,74264,23469,50795,3.537,11.193,18849,2.841,22.387,2647,2707,13941
1996,32,29096,34678,701193,680114,5519,16.253,4077,12.006,141917,61380,80537,9.025,20.867,100162,38595,61567,5.675,14.727,41755,6.139,29.454,2853,2905,22958
1996,33,26935,31705,478705,471624,3767,12.034,2961,9.459,71051,23192,47859,4.917,15.065,56874,19054,37820,4.040,12.059,14177,3.006,24.118,2018,2092,11818
1996,34,169043,197549,3163337,3151116,22750,11.595,20060,10.224,496145,176861,319284,5.613,15.745,473447,155911,317536,4.948,15.025,22698,0.720,30.049,14097,14320,80700
1996,35,30952,37132,506709,500603,4651,12.656,3885,10.572,89505,32143,57362,6.421,17.879,77130,27939,49191,5.581,15.407,12375,2.472,30.815,2691,2732,15604
1996,36,350750,411170,6597246,6585190,46529,11.357,43552,10.631,955197,346519,608678,5.262,14.505,930993,316676,614317,4.809,14.138,24204,0.368,28.275,31586,32271,188692
1996,37,134507,169399,3019811,2982631,20000,11.972,15323,9.172,455267,173892,281375,5.830,15.264,380172,122260,257912,4.099,12.746,75095,2.518,25.492,10391,10647,60937
1996,38,15441,18255,231994,230366,1622,8.922,1473,8.102,32161,9989,22172,4.336,13.961,28834,8583,20251,3.726,12.517,3327,1.444,25.033,1019,1039,5039
1996,39,187600,241050,4525605,4494665,23604,9.849,20841,8.696,638568,217396,421172,4.837,14.207,575515,177274,398241,3.944,12.804,63053,1.403,25.609,14064,14473,92574
1996,40,61084,74434,1054243,1038800,8608,11.656,7437,10.071,170052,67486,102566,6.497,16.370,139593,49202,90391,4.736,13.438,30459,2.932,26.876,5422,5531,30378
1996,41,70660,84542,1213381,1187065,10690,12.811,8494,10.179,207703,70706,136997,5.956,17.497,155582,52021,103561,4.382,13.106,52121,4.391,26.213,6060,6188,34141
1996,42,208543,261140,4646625,4624088,24588,9.453,22520,8.658,623692,223102,400590,4.825,13.488,580605,190077,390528,4.111,12.556,43087,0.932,25.112,15602,16037,101759
1996,44,21772,24605,369831,369308,2608,10.650,2374,9.695,48822,16423,32399,4.447,13.220,48079,15844,32235,4.290,13.019,743,0.201,26.037,1683,1693,8819
1996,45,65311,81792,1419699,1406527,10111,12.516,8091,10.016,216716,81513,135203,5.795,15.408,189821,60280,129541,4.286,13.496,26895,1.912,26.991,5648,5806,35233
1996,46,17580,20514,274623,271490,2135,10.488,1822,8.950,39190,15726,23464,5.792,14.435,32882,10773,22109,3.968,12.112,6308,2.323,24.223,1311,1345,6594
1996,47,91203,115720,2148355,2129821,13732,12.004,11073,9.680,329697,127052,202645,5.965,15.480,292659,98491,194168,4.624,13.741,37038,1.739,27.482,7894,8045,54737
1996,48,313662,402617,6808504,6708161,51614,12.954,43262,10.858,1229674,476952,752722,7.110,18.331,1028236,354642,673594,5.287,15.328,201438,3.003,30.656,29890,30900,204294
1996,49,34628,41803,773573,754054,6192,15.163,4258,10.427,140057,57183,82874,7.583,18.574,100779,32904,67875,4.364,13.365,39278,5.209,26.730,3038,3112,22023
1996,50,16113,18322,222677,219777,1885,10.345,1685,9.247,33243,13880,19363,6.315,15.126,27567,10699,16868,4.868,12.543,5676,2.583,25.086,1231,1252,6480
1996,51,116868,148858,2503927,2482853,16935,11.471,14488,9.813,391984,144789,247195,5.832,15.788,350768,112010,238758,4.511,14.128,41216,1.660,28.255,9844,10140,55754
1996,53,112880,136158,1954188,1933633,18304,13.605,15064,11.197,314099,120820,193279,6.248,16.244,272220,87738,184482,4.537,14.078,41879,2.166,28.156,10548,10787,58041
1996,54,30311,37141,522636,524059,3843,10.392,3520,9.519,74457,28269,46188,5.394,14.208,77472,23575,53897,4.499,14.783,-3015,-0.575,28.416,2431,2465,13038
1996,55,99767,121822,2193526,2176967,11712,9.685,9921,8.204,271981,87353,184628,4.013,12.494,238570,69099,169471,3.174,10.959,33411,1.535,21.918,7053,7201,38520
1996,56,13130,15221,152332,151982,1826,12.122,1510,10.025,22852,8248,14604,5.427,15.036,22265,6436,15829,4.235,14.650,587,0.386,29.300,1058,1089,4510
1997,01,71664,90071,1550255,1539577,10773,12.028,9760,10.897,265324,98458,166866,6.395,17.234,244521,90602,153919,5.885,15.882,20803,1.351,31.765,6656,6796,46825
1997,02,12430,14822,183874,180752,1904,12.962,1639,11.158,36353,10322,26031,5.711,20.112,30276,9632,20644,5.329,16.750,6077,3.362,33.500,1044,1056,4762
1997,04,76606,95246,1672602,1627481,14446,15.407,11484,12.248,367295,140324,226971,8.622,22.568,277874,114832,163042,7.056,17.074,89421,5.494,34.148,7476,7649,52278
1997,05,46076,55638,905859,899113,6693,12.082,6208,11.207,144445,51159,93286,5.690,16.065,131038,49478,81560,5.503,14.574,13407,1.491,29.148,4324,4422,24673
1997,06,542404,667158,11252313,11071650,86820,13.057,82345,12.384,2217999,782069,1435930,7.064,20.033,1852853,731242,1121611,6.605,16.735,365146,3.298,33.470,51661,53536,362767
1997,08,91834,109441,1647606,1615226,15800,14.643,12719,11.788,334283,133251,201032,8.250,20.696,268991,106598,162393,6.600,16.653,65292,4.042,33.307,8398,8551,52045
1997,09,69474,82378,1451581,1430912,8392,10.189,8367,10.158,244627,79726,164901,5.572,17.096,203151,78629,124522,5.495,14.197,41476,2.899,28.395,5363,5525,35300
1997,10,15967,19106,347695,341261,2481,13.138,2036,10.782,61405,22879,38526,6.704,17.994,49067,17756,31311,5.203,14.378,12338,3.615,28.756,1275,1291,8133
1997,11,14262,17348,373871,368861,1886,10.823,2043,11.724,60038,22944,37094,6.220,16.277,49844,17682,32162,4.794,13.513,10194,2.764,27.026,1171,1228,7248
1997,12,297634,365936,5462574,5394033,52410,14.419,47474,13.061,1118391,429895,688496,7.970,20.734,978226,416524,561702,7.722,18.135,140165,2.599,36.271,33336,34259,230217
1997,13,131935,167324,3036115,2998848,22500,13.579,19257,11.621,571917,210083,361834,7.005,19.071,498386,189493,308893,6.319,16.619,73531,2.452,33.239,12784,13087,91430
1997,15,21623,27184,416762,416991,2845,10.442,2970,10.900,59509,19849,39660,4.760,14.271,59726,20186,39540,4.841,14.323,-217,-0.052,28.542,1908,1965,11032
1997,16,26119,30590,395358,389601,4363,14.475,3467,11.502,73764,27282,46482,7.003,18.933,62751,23797,38954,6.108,16.106,11013,2.827,32.213,2295,2341,13659
1997,17,216941,265991,4993554,4951190,28962,10.922,27346,10.312,795419,265355,530064,5.359,16.065,711695,251005,460690,5.070,14.374,83724,1.691,28.748,17760,18282,121821
1997,18,103553,131403,2431839,2410952,14130,10.798,13046,9.969,379435,120468,258967,4.997,15.738,338853,118909,219944,4.932,14.055,40582,1.683,28.109,8710,8985,59978
1997,19,57943,72039,1156199,1149849,6934,9.645,6634,9.228,172489,63485,109004,5.521,15.001,159819,58085,101734,5.052,13.899,12670,1.102,27.798,4377,4485,27521
1997,20,53793,65951,1028022,1013186,7334,11.180,6630,10.107,169724,61325,108399,6.053,16.752,139939,50621,89318,4.996,13.812,29785,2.940,27.624,4356,4451,25527
1997,21,64108,79993,1398661,1373699,9005,11.329,7990,10.052,237998,82382,155616,5.997,17.325,187654,66803,120851,4.863,13.660,50344,3.665,27.321,5337,5485,35569
1997,22,72475,90272,1478836,1461576,10256,11.426,9228,10.281,265109,89828,175281,6.146,18.139,230291,82086,148205,5.616,15.756,34818,2.382,31.513,6165,6328,41935
1997,23,27576,32411,442285,436681,3798,11.828,3196,9.953,66407,22281,44126,5.102,15.207,55355,21118,34237,4.836,12.676,11052,2.531,25.353,2143,2189,12413
1997,24,90117,111102,1867588,1839308,13451,12.159,12500,11.299,344630,125484,219146,6.822,18.737,288222,109260,178962,5.940,15.670,56408,3.067,31.340,8031,8277,50717
1997,25,121207,147163,2777538,2747059,16159,11.072,13715,9.398,451192,160196,290996,5.832,16.425,392214,142438,249776,5.185,14.278,58978,2.147,28.555,8822,9054,67708
1997,26,166882,206726,3760922,3715176,22247,10.794,20994,10.186,628441,200464,427977,5.396,16.916,532670,188889,343781,5.084,14.338,95771,2.578,28.675,13709,14212,92279
1997,27,94540,115445,2146716,2118245,12860,11.243,10744,9.393,336493,108820,227673,5.137,15.885,279796,101011,178785,4.769,13.209,56697,2.677,26.418,6869,7100,49093
1997,28,43287,53546,885191,873146,6267,11.779,5583,10.494,147174,49189,97985,5.634,16.856,122997,39027,83970,4.470,14.087,24177,2.769,28.173,3868,3921,21471
1997,29,103284,127468,2221387,2188467,14223,11.169,13985,10.982,365637,119120,246517,5.443,16.707,299225,102750,196475,4.695,13.673,66412,3.035,27.346,9558,9847,55334
1997,30,22942,26382,269493,266610,3219,12.323,2699,10.332,47181,16674,30507,6.254,17.697,41349,14683,26666,5.507,15.509,5832,2.187,31.018,1817,1842,8488
1997,31,35763,43182,681075,677437,4361,10.140,4016,9.337,105136,38968,66168,5.752,15.520,97912,32236,65676,4.759,14.453,7224,1.066,28.907,2668,2746,16646
1997,32,30552,36585,752560,730890,6459,18.122,4571,12.825,155980,61906,94074,8.470,21.341,113085,41023,72062,5.613,15.472,42895,5.869,30.944,2991,3054,20337
1997,33,27429,32274,495624,488564,3737,11.680,3177,9.930,78127,25057,53070,5.129,15.991,63988,23296,40692,4.768,13.097,14139,2.894,26.194,2071,2118,11411
1997,34,171554,199985,3247502,3211726,24465,12.308,22047,11.091,590940,203852,387088,6.347,18.399,515577,208351,307226,6.487,16.053,75363,2.346,32.106,14551,14929,97737
1997,35,31067,37584,515644,512038,4921,13.174,4462,11.945,96996,39033,57963,7.623,18.943,89933,32282,57651,6.305,17.564,7063,1.379,35.127,2953,2997,19194
1997,36,354014,414759,6734866,6684297,49191,11.909,45774,11.082,1095931,368041,727890,5.506,16.396,992541,376817,615724,5.637,14.849,103390,1.547,29.698,32346,32998,195354
1997,37,138432,175537,3125286,3073871,22923,13.291,16788,9.734,525693,189133,336560,6.153,17.102,422000,151982,270018,4.944,13.729,103693,3.373,27.457,10986,11282,73667
1997,38,15304,18118,240676,236566,1634,8.985,1770,9.733,38989,12227,26762,5.169,16.481,30533,11847,18686,5.008,12.907,8456,3.574,25.814,1204,1234,7649
1997,39,188460,242424,4610631,4576574,24938,10.315,23636,9.776,716531,254383,462148,5.558,15.656,647148,219479,427669,4.796,14.140,69383,1.516,28.281,14918,15419,100301
1997,40,61612,75321,1093451,1075382,9146,12.213,8280,11.057,198198,70671,127527,6.572,18.430,161763,56908,104855,5.292,15.042,36435,3.388,30.085,5686,5818,34623
1997,41,71792,85947,1270372,1247910,11000,12.900,9649,11.316,234460,77368,157092,6.200,18.788,188417,68866,119551,5.519,15.099,46043,3.690,30.197,6458,6562,35228
1997,42,209888,263398,4750940,4703612,26707,10.182,24509,9.344,736612,252262,484350,5.363,15.661,642523,235219,407304,5.001,13.660,94089,2.000,27.320,15717,16304,119823
1997,44,22005,24818,385463,381241,2643,10.692,2444,9.887,59290,19469,39821,5.107,15.552,50952,17129,33823,4.493,13.365,8338,2.187,26.730,1726,1744,9651
1997,45,66710,83777,1452259,1436527,10735,12.966,8763,10.584,241761,90091,151670,6.271,16.830,209698,78760,130938,5.483,14.598,32063,2.232,29.195,5879,6021,42747
1997,46,17665,20675,279560,277238,2214,10.751,2052,9.964,42081,15045,27036,5.427,15.179,37573,13610,23963,4.909,13.553,4508,1.626,27.105,1345,1390,7203
1997,47,91932,117390,2210238,2183464,14171,12.157,12521,10.742,377342,130989,246353,5.999,17.282,322900,110089,212811,5.042,14.788,54442,2.493,29.577,8399,8655,59094
1997,48,316834,408113,7093189,6962734,53169,13.114,47827,11.796,1426237,539857,886380,7.754,20.484,1163502,439608,723894,6.314,16.710,262735,3.773,33.421,31659,32718,232540
1997,49,35981,43420,821074,798394,6514,15.282,4927,11.559,169229,62897,106332,7.878,21.196,122350,47007,75343,5.888,15.325,46879,5.872,30.649,3299,3391,24108
1997,50,16313,18543,227262,224810,2014,10.926,1795,9.738,34254,14355,19899,6.385,15.237,29560,10476,19084,4.660,13.149,4694,2.088,26.298,1253,1266,6072
1997,51,119024,151736,2610798,2556813,18558,12.346,15710,10.452,470270,161152,309118,6.303,18.393,362341,132501,229840,5.182,14.172,107929,4.221,28.343,9845,10256,62675
1997,53,114684,138096,2001464,1967996,18910,13.788,17016,12.407,382932,134129,248803,6.816,19.458,315220,122481,192739,6.224,16.017,67712,3.441,32.035,10778,11012,62639
1997,54,30462,37513,535036,529680,4085,10.942,3724,9.975,84756,29611,55145,5.590,16.001,73877,24447,49430,4.615,13.947,10879,2.054,27.895,2486,2550,12884
1997,55,100719,123158,2251294,2227266,12262,10.009,10966,8.951,322706,106348,216358,4.775,14.489,274481,91744,182737,4.119,12.324,48225,2.165,24.647,7219,7450,45991
1997,56,13247,15198,155480,153814,1797,11.815,1820,11.966,28723,9451,19272,6.144,18.674,25363,10365,14998,6.739,16.489,3360,2.184,32.979,1059,1070,4581
1998,01,72228,91138,1605798,1593134,10110,11.138,9369,10.322,247085,83916,163169,5.267,15.509,220509,74095,146414,4.651,13.841,26576,1.668,27.682,6458,6629,40114
1998,02,12724,15189,196311,191934,1903,12.647,1618,10.753,36644,12621,24023,6.576,19.092,28013,8799,19214,4.584,14.595,8631,4.497,29.190,1016,1051,4624
1998,04,78049,97332,1753199,1717776,12982,13.458,11241,11.653,337885,126247,211638,7.349,19.670,268426,102887,165539,5.990,15.626,69459,4.044,31.253,7434,7620,51541
1998,05,46073,56083,947370,931314,6345,11.340,6083,10.872,150207,58232,91975,6.253,16.129,117864,40425,77439,4.341,12.656,32343,3.473,25.311,4242,4342,24718
1998,06,553436,681113,11889863,11643807,84064,12.445,72830,10.782,2201769,721552,1480217,6.197,18.909,1708045,608337,1099708,5.225,14.669,493724,4.240,29.338,46822,48035,310947
1998,08,94569,113268,1757981,1711413,15645,14.025,12214,10.949,343119,125033,218086,7.306,20.049,249556,86772,162784,5.070,14.582,93563,5.467,29.164,8221,8330,45930
1998,09,69756,82992,1484508,1472978,7950,9.598,7633,9.215,223527,75938,147589,5.155,15.175,201047,58908,142139,3.999,13.649,22480,1.526,27.298,4957,5066,27764
1998,10,16466,19708,354168,352076,2435,12.494,1998,10.252,60151,21007,39144,5.967,17.085,54735,19154,35581,5.440,15.546,5416,1.538,31.093,1221,1236,7689
1998,11,14373,17491,389409,386839,1800,10.306,1748,10.009,58026,19992,38034,5.168,15.000,52645,17713,34932,4.579,13.609,5381,1.391,27.218,947,976,7384
1998,12,301721,372168,5750350,5635644,50065,13.546,44923,12.155,1160500,449670,710830,7.979,20.592,929726,388620,541106,6.896,16.497,230774,4.095,32.994,30696,31674,200204
1998,13,135157,172402,3209963,3149973,23207,13.638,18737,11.011,600719,230327,370392,7.312,19.071,477516,177753,299763,5.643,15.159,123203,3.911,30.319,12132,12520,83728
1998,15,21649,27120,410074,412889,2629,9.662,2806,10.313,56276,21333,34943,5.167,13.630,61718,20982,40736,5.082,14.948,-5442,-1.318,27.260,1735,1774,9769
1998,16,26696,31363,423189,413397,4044,13.030,3388,10.917,79694,31599,48095,7.644,19.278,59814,19099,40715,4.620,14.469,19880,4.809,28.938,2313,2333,11215
1998,17,219962,270315,5182965,5120740,27692,10.308,24358,9.067,785554,246453,539101,4.813,15.341,659277,207812,451465,4.058,12.875,126277,2.466,25.749,15892,16281,99429
1998,18,104591,133080,2529580,2497961,13262,10.013,11999,9.059,370831,127490,243341,5.104,14.845,306504,96325,210179,3.856,12.270,64327,2.575,24.540,7949,8147,49606
1998,19,58614,73025,1216578,1194963,6688,9.201,6011,8.270,169558,49941,119617,4.179,14.189,126386,39587,86799,3.313,10.577,43172,3.613,21.153,3986,4081,20779
1998,20,54488,67054,1078552,1061988,7062,10.592,6300,9.449,171764,59810,111954,5.632,16.174,138207,49454,88753,4.657,13.014,33557,3.160,26.028,4205,4334,24729
1998,21,64942,81554,1451006,1431597,8718,10.778,7380,9.124,233792,87342,146450,6.101,16.331,193295,59386,133909,4.148,13.502,40497,2.829,27.004,4992,5082,29410
1998,22,73393,91598,1565090,1541110,9750,10.703,8752,9.607,269045,90191,178854,5.852,17.458,219602,73452,146150,4.766,14.250,49443,3.208,28.499,5818,6006,41487
1998,23,28242,33218,460666,454001,3757,11.432,3050,9.281,66057,21573,44484,4.752,14.550,52218,16734,35484,3.686,11.502,13839,3.048,23.003,2064,2092,9869
1998,24,91107,112498,1945879,1918007,12484,11.147,11483,10.253,323872,118153,205719,6.160,16.886,267842,95836,172006,4.997,13.965,56030,2.921,27.929,7276,7535,46679
1998,25,123187,149634,2877879,2841653,14888,10.013,13003,8.745,443397,137533,305864,4.840,15.603,369018,110475,258543,3.888,12.986,74379,2.617,25.972,8242,8425,53851
1998,26,168484,209354,3891469,3848029,21152,10.147,19342,9.279,587103,191784,395319,4.984,15.257,499228,154357,344871,4.011,12.974,87875,2.284,25.947,12824,13314,81595
1998,27,97011,118194,2262998,2217782,12100,10.337,9823,8.392,357746,106081,251665,4.783,16.131,267378,79294,188084,3.575,12.056,90368,4.075,24.112,6442,6589,41990
1998,28,43723,54277,938957,925433,5950,11.018,5403,10.005,140031,46575,93456,5.033,15.131,113496,39373,74123,4.255,12.264,26535,2.867,24.528,3731,3817,22450
1998,29,104378,129226,2296584,2278259,13822,10.747,12593,9.792,334342,118186,216156,5.188,14.675,298278,90583,207695,3.976,13.092,36064,1.583,26.185,8450,8638,47059
1998,30,23499,27055,277490,275666,3322,12.411,2746,10.259,45035,16811,28224,6.098,16.337,41518,16388,25130,5.945,15.061,3517,1.276,30.122,1890,1930,8307
1998,31,36095,43713,713165,701505,4143,9.511,3836,8.806,104687,31113,73574,4.435,14.923,81049,27339,53710,3.897,11.554,23638,3.370,23.107,2611,2686,14941
1998,32,32037,38598,805739,785471,6248,16.590,4373,11.612,153934,62248,91686,7.925,19.598,113239,37333,75906,4.753,14.417,40695,5.181,28.833,2916,2946,18773
1998,33,28069,32903,521633,510810,3488,10.688,2953,9.048,82828,24749,58079,4.845,16.215,61088,20136,40952,3.942,11.959,21740,4.256,23.918,1923,1961,11662
1998,34,174670,204039,3399950,3346738,23259,11.496,19823,9.798,592286,192502,399784,5.752,17.697,484679,160311,324368,4.790,14.482,107607,3.215,28.964,13044,13246,74880
1998,35,31454,38144,537524,533499,4513,11.895,4106,10.822,89915,34669,55246,6.498,16.854,82156,30373,51783,5.693,15.399,7759,1.454,30.799,2674,2755,15096
1998,36,360104,422116,6932212,6859932,46339,11.059,40136,9.579,1127527,350598,776929,5.111,16.436,980801,309760,671041,4.515,14.298,146726,2.139,28.595,27040,27476,147330
1998,37,141587,180429,3242314,3201048,21456,12.036,17117,9.602,508691,184125,324566,5.752,15.891,425635,156663,268972,4.894,13.297,83056,2.595,26.593,11156,11422,68096
1998,38,15439,18280,251512,247324,1643,9.014,1539,8.443,37557,12352,25205,4.994,15.185,29475,10269,19206,4.152,11.918,8082,3.268,23.835,1031,1063,5513
1998,39,190329,244976,4797652,4731596,22797,9.336,21218,8.689,714814,222322,492492,4.699,15.107,583034,190535,392499,4.027,12.322,131780,2.785,24.644,13504,13951,86938
1998,40,62369,76405,1154176,1131231,8519,11.205,7770,10.220,196853,66476,130377,5.876,17.402,151287,56483,94804,4.993,13.374,45566,4.028,26.747,5238,5410,33162
1998,41,72997,87357,1303024,1291788,10440,12.029,9309,10.726,213316,76984,136332,5.959,16.513,189185,66891,122294,5.178,14.645,24131,1.868,29.290,6079,6174,33422
1998,42,212227,266766,4892126,4844384,24599,9.263,22164,8.346,693284,215197,478087,4.442,14.311,596897,178437,418460,3.683,12.321,96387,1.990,24.643,14195,14638,86561
1998,44,22357,25170,403670,396350,2467,9.853,2201,8.791,59688,19506,40182,4.921,15.059,44660,11704,32956,2.953,11.268,15028,3.792,22.536,1501,1514,6296
1998,45,68250,85944,1537051,1504725,10352,12.179,8459,9.952,261081,88072,173009,5.853,17.351,196395,66902,129493,4.446,13.052,64686,4.299,26.104,5557,5660,32474
1998,46,17920,20982,294642,288435,2122,10.166,1904,9.122,43169,13492,29677,4.678,14.967,31009,10328,20681,3.581,10.751,12160,4.216,21.502,1326,1363,6336
1998,47,92681,119151,2299211,2267109,13546,11.437,12126,10.238,375380,141371,234009,6.236,16.558,310405,109235,201170,4.818,13.692,64975,2.866,27.383,8038,8236,48815
1998,48,322527,416742,7541977,7370039,51549,12.476,44463,10.761,1444142,512611,931531,6.955,19.595,1099080,371234,727846,5.037,14.913,345062,4.682,29.826,28790,30039,186248
1998,49,37094,44815,845526,836732,6269,14.189,5002,11.321,156827,58353,98474,6.974,18.743,138854,40991,97863,4.899,16.595,17973,2.148,33.190,3318,3368,22758
1998,50,16478,18664,237256,233018,1855,9.957,1788,9.597,34454,10478,23976,4.497,14.786,25928,8818,17110,3.784,11.127,8526,3.659,22.254,1216,1244,5062
1998,51,121297,155468,2706198,2668288,18087,11.757,14839,9.645,439791,160346,279445,6.009,16.482,362129,124994,237135,4.684,13.572,77662,2.911,27.143,9373,9694,55605
1998,53,117328,141427,2091711,2060054,17954,12.822,15141,10.813,353056,115937,237119,5.628,17.138,289592,96503,193089,4.684,14.057,63464,3.081,28.115,10073,10241,54039
1998,54,30608,37900,550397,544606,3696,9.789,3411,9.034,84359,32135,52224,5.901,15.490,73109,20543,52566,3.772,13.424,11250,2.066,26.848,2273,2302,11176
1998,55,102118,124949,2318201,2292558,11625,9.355,10264,8.260,312787,92828,219959,4.049,13.644,260810,84271,176539,3.676,11.376,51977,2.267,22.753,6768,6943,40841
1998,56,13598,15624,164334,162301,1834,11.873,1479,9.575,29006,10617,18389,6.542,17.872,25022,9010,16012,5.551,15.417,3984,2.455,30.834,1024,1040,4622
1999,01,72231,91525,1618074,1612302,9670,10.587,9290,10.171,248234,90728,157506,5.627,15.396,236881,81495,155386,5.055,14.692,11353,0.704,29.384,6271,6433,40445
1999,02,12787,15303,196143,195733,1729,11.341,1613,10.581,28878,8228,20650,4.204,14.754,28034,7964,20070,4.069,14.323,844,0.431,28.645,1053,1073,4470
1999,04,79583,99841,1816587,1783158,13841,14.039,11339,11.501,348825,130310,218515,7.308,19.562,280744,107632,173112,6.036,15.744,68081,3.818,31.488,7308,7577,56119
1999,05,46100,56352,951498,949550,6284,11.174,6056,10.769,142343,47575,94768,5.010,14.991,138609,55788,82821,5.875,14.597,3734,0.393,29.195,4146,4266,24990
1999,06,561198,691186,12169960,12040910,84751,12.350,74840,10.906,2175070,778696,1396374,6.467,18.064,1919606,719671,1199935,5.977,15.942,255464,2.122,31.885,46912,48456,347627
1999,08,96486,116046,1822144,1790608,15510,13.527,12738,11.109,349554,133672,215882,7.465,19.522,286120,113751,172369,6.353,15.979,63434,3.543,31.958,8387,8638,52158
1999,09,69599,83131,1518236,1502471,7671,9.233,7580,9.123,224645,71738,152907,4.775,14.952,192124,68192,123932,4.539,12.787,32521,2.165,25.574,4884,5021,29123
1999,10,16828,20112,358710,356666,2447,12.287,2055,10.318,57651,23193,34458,6.503,16.164,53395,18487,34908,5.183,14.971,4256,1.193,29.941,1229,1257,8258
1999,11,14348,17499,392131,390846,1813,10.364,1801,10.296,56489,19947,36542,5.104,14.453,53183,22425,30758,5.738,13.607,3306,0.846,27.214,976,1000,7245
1999,12,303571,375084,5924991,5848794,50412,13.493,47467,12.705,1166736,395959,770777,6.770,19.948,1015748,418862,596886,7.162,17.367,150988,2.582,34.734,31264,32265,210382
1999,13,137449,175078,3334977,3274198,22285,12.828,19584,11.273,603721,218610,385111,6.677,18.439,479868,178801,301067,5.461,14.656,123853,3.783,29.312,12311,12702,85715
1999,15,21572,26995,415280,413436,2564,9.474,2702,9.984,59003,23931,35072,5.788,14.271,55480,20361,35119,4.925,13.419,3523,0.852,26.838,1681,1752,10747
1999,16,27268,32292,435990,429928,4159,13.063,3249,10.205,71121,27297,43824,6.349,16.543,58905,23780,35125,5.531,13.701,12216,2.841,27.402,2211,2245,12939
1999,17,220530,272205,5320557,5258068,27071,9.979,25243,9.305,804474,280185,524289,5.329,15.300,677892,226378,451514,4.305,12.892,126582,2.407,25.785,16238,16713,105174
1999,18,104347,133537,2565765,2549102,12565,9.424,12153,9.115,354363,106286,248077,4.170,13.901,319936,105513,214423,4.139,12.551,34427,1.351,25.102,8223,8445,55869
1999,19,58464,73377,1245878,1231850,6440,8.795,6139,8.384,175566,57801,117765,4.692,14.252,147356,48200,99156,3.913,11.962,28210,2.290,23.924,4231,4347,24365
1999,20,54521,67369,1099008,1088501,6739,10.027,6424,9.558,172002,60967,111035,5.601,15.802,150144,59941,90203,5.507,13.794,21858,2.008,27.587,4227,4344,25137
1999,21,65140,82054,1459168,1453731,8408,10.280,7873,9.626,214160,77937,136223,5.361,14.732,204619,63490,141129,4.367,14.075,9541,0.656,28.151,5190,5348,32439
1999,22,73226,91852,1573369,1571506,9341,10.183,9101,9.921,242372,79891,162481,5.084,15.423,238425,85618,152807,5.448,15.172,3947,0.251,30.344,6042,6258,49110
1999,23,28829,33870,471937,466693,3665,10.921,3041,9.062,68390,22345,46045,4.788,14.654,57939,18821,39118,4.033,12.415,10451,2.239,24.830,2030,2075,11163
1999,24,91667,113059,1970028,1956771,12115,10.743,11534,10.228,322950,111391,211559,5.693,16.504,295538,109697,185841,5.606,15.103,27412,1.401,30.207,7132,7279,51788
1999,25,125429,152052,2931474,2907004,15893,10.535,13521,8.962,444283,141683,302600,4.874,15.283,395666,129597,266069,4.458,13.611,48617,1.672,27.222,8539,8809,61853
1999,26,168425,210147,3958937,3927889,20301,9.678,19517,9.305,593783,204646,389137,5.210,15.117,530446,170200,360246,4.333,13.505,63337,1.612,27.009,12903,13255,84806
1999,27,98215,120169,2315569,2289800,12325,10.340,10391,8.717,335200,115235,219965,5.033,14.639,283386,99978,183408,4.366,12.376,51814,2.263,24.752,6707,6932,45009
1999,28,43797,54636,942839,940229,5971,10.961,5646,10.365,136723,44509,92214,4.734,14.541,131848,48753,83095,5.185,14.023,4875,0.518,28.046,3924,3999,24071
1999,29,104565,130026,2338005,2320273,13585,10.479,12825,9.892,343415,109946,233469,4.738,14.801,307442,107741,199701,4.643,13.250,35973,1.550,26.501,8629,8827,49052
1999,30,23699,27344,288246,282574,3013,11.075,2738,10.064,47803,16352,31451,5.787,16.917,36589,13447,23142,4.759,12.948,11214,3.969,25.897,1861,1904,8558
1999,31,36242,43983,726886,720782,3998,9.114,3769,8.592,106309,32820,73489,4.553,14.749,93637,37368,56269,5.184,12.991,12672,1.758,25.982,2562,2654,20916
1999,32,33293,40648,860966,833920,6714,16.941,4679,11.807,177841,73778,104063,8.847,21.326,123157,41029,82128,4.920,14.768,54684,6.557,29.537,3095,3196,22552
1999,33,28383,33431,532247,526875,3366,10.145,2859,8.617,73151,23641,49510,4.487,13.884,62311,19217,43094,3.647,11.827,10840,2.057,23.653,1958,2008,10896
1999,34,175457,205213,3442159,3418073,22163,10.831,20986,10.256,545502,188932,356570,5.527,15.959,496239,168011,328228,4.915,14.518,49263,1.441,29.036,13630,13933,89168
1999,35,31335,38391,538804,539390,4429,11.571,4199,10.970,86501,33651,52850,6.239,16.037,87425,28897,58528,5.357,16.208,-924,-0.171,32.074,2767,2828,15754
1999,36,361919,425792,7033315,6985990,45002,10.614,41387,9.761,1045370,338772,706598,4.849,14.964,950611,327310,623301,4.685,13.607,94759,1.356,27.215,28001,28496,163152
1999,37,143872,182265,3318114,3283133,20801,11.470,18964,10.457,541759,189960,351799,5.786,16.501,473121,175512,297609,5.346,14.411,68638,2.091,28.821,11396,11798,72611
1999,38,15371,18296,251110,251817,1477,8.074,1471,8.041,31900,11725,20175,4.656,12.668,32929,10408,22521,4.133,13.077,-1029,-0.409,25.336,1002,1021,5414
1999,39,190040,245663,4823758,4812364,21866,8.913,21207,8.644,674954,216068,458886,4.490,14.025,654233,228974,425259,4.758,13.595,20721,0.431,27.190,13613,14159,95355
1999,40,62222,76554,1154069,1155277,8407,10.991,8276,10.820,185520,68189,117331,5.902,16.058,188474,71187,117287,6.162,16.314,-2954,-0.256,32.117,5476,5640,34830
1999,41,73447,88314,1318421,1310371,10348,11.780,9405,10.707,209888,71502,138386,5.457,16.017,193713,75787,117926,5.784,14.783,16175,1.234,29.566,6337,6513,38640
1999,42,212310,267317,4940574,4917556,23909,8.952,23416,8.768,685013,229923,455090,4.676,13.930,640568,215472,425096,4.382,13.026,44445,0.904,26.052,14905,15345,95993
1999,44,22255,25191,410163,408916,2363,9.383,2350,9.331,55309,16396,38913,4.010,13.526,52936,15418,37518,3.770,12.945,2373,0.580,25.891,1655,1669,7786
1999,45,69461,87461,1566889,1551498,10249,11.821,8730,10.069,244384,84229,160155,5.429,15.751,215532,72341,143191,4.663,13.892,28852,1.860,27.784,5586,5857,35673
1999,46,17972,21115,297988,296161,2077,9.866,1952,9.272,39518,14297,25221,4.827,13.343,35867,12231,23636,4.130,12.111,3651,1.233,24.221,1345,1383,6319
1999,47,92334,119735,2333190,2321679,13118,10.984,12514,10.478,360567,129285,231282,5.569,15.530,339227,120201,219026,5.177,14.611,21340,0.919,29.223,8174,8416,51628
1999,48,323199,420805,7698271,7627936,50737,12.115,46727,11.157,1405018,487740,917278,6.394,18.419,1263806,476412,787394,6.246,16.568,141212,1.851,33.136,30364,31443,230486
1999,49,38096,46478,881680,871566,6769,14.828,5112,11.198,153111,58891,94220,6.757,17.567,132431,49995,82436,5.736,15.195,20680,2.373,30.389,3473,3574,29384
1999,50,16702,19036,243226,240476,1922,10.194,1558,8.263,32980,10724,22256,4.459,13.714,27367,9108,18259,3.787,11.380,5613,2.334,22.761,1142,1161,6106
1999,51,122020,156384,2779905,2744003,16956,10.875,16026,10.278,445171,152828,292343,5.570,16.223,373728,129892,243836,4.734,13.620,71443,2.604,27.240,9586,9922,60023
1999,53,118059,142720,2153445,2123516,17271,12.155,16007,11.266,366551,135612,230939,6.386,17.262,306826,108478,198348,5.108,14.449,59725,2.813,28.898,10619,11026,59749
1999,54,30527,37836,545687,546249,3571,9.436,3587,9.478,73845,28067,45778,5.138,13.519,75265,25801,49464,4.723,13.779,-1420,-0.260,27.037,2372,2435,12744
1999,55,102462,125943,2356884,2337681,11281,8.991,10338,8.239,312001,93557,218444,4.002,13.347,273765,86122,187643,3.684,11.711,38236,1.636,23.422,6938,7138,43246
1999,56,13564,15681,169088,166786,1746,11.154,1691,10.803,28898,9707,19191,5.820,17.326,24316,8782,15534,5.265,14.579,4582,2.747,29.158,1139,1148,4685
2000,01,71652,91235,1652942,1637400,9241,10.110,9573,10.474,251594,73920,177674,4.514,15.365,220756,79574,141182,4.860,13.482,30838,1.883,26.964,6436,6654,42878
2000,02,12799,15381,207991,202600,1777,11.575,1718,11.191,38936,13755,25181,6.789,19.218,28061,10483,17578,5.174,13.850,10875,5.368,27.701,1113,1148,6102
2000,04,80453,101842,1920817,1873574,13568,13.451,11621,11.521,376454,134645,241809,7.187,20.093,282027,94290,187737,5.033,15.053,94427,5.040,30.106,7647,7892,51395
2000,05,46208,56779,987881,970288,6270,11.081,5877,10.387,150788,46062,104726,4.747,15.541,115097,41104,73993,4.236,11.862,35691,3.678,23.724,4002,4087,23127
2000,06,569105,701933,12703101,12453273,83704,12.015,73186,10.505,2337109,757182,1579927,6.080,18.767,1836977,677173,1159804,5.438,14.751,500132,4.016,29.502,46504,48254,322018
2000,08,98332,118749,1921584,1874693,15548,13.241,12889,10.977,362654,129069,233585,6.885,19.345,267790,95503,172287,5.094,14.284,94864,5.060,28.569,8336,8627,51615
2000,09,69732,83375,1541748,1533203,7530,9.041,7353,8.829,213775,68690,145085,4.480,13.943,195786,66783,129003,4.356,12.770,17989,1.173,25.539,4645,4810,28783
2000,10,17283,20761,378416,368889,2680,13.099,2076,10.147,69616,30011,39605,8.136,18.872,50658,17677,32981,4.792,13.733,18958,5.139,27.465,1268,1290,6794
2000,11,14398,17713,405539,399309,1780,10.102,1593,9.041,57253,18722,38531,4.689,14.338,45110,12512,32598,3.133,11.297,12143,3.041,22.594,901,907,5697
2000,12,304306,377158,6181402,6053143,48709,12.949,46727,12.422,1195113,405460,789653,6.698,19.744,937032,386095,550937,6.378,15.480,258081,4.264,30.960,30788,31671,191524
2000,13,138492,177531,3436072,3384667,22243,12.614,19857,11.261,604718,210992,393726,6.234,17.866,500697,179386,321311,5.300,14.793,104021,3.073,29.586,12679,12979,85042
2000,15,21768,27181,430883,423435,2569,9.483,2387,8.811,60045,19009,41036,4.489,14.180,45426,17144,28282,4.049,10.728,14619,3.452,21.456,1496,1546,8564
2000,16,27594,32745,454106,447941,3972,12.213,3525,10.839,82507,34007,48500,7.592,18.419,69831,21377,48454,4.772,15.589,12676,2.830,31.179,2318,2389,13334
2000,17,220860,273833,5465576,5398230,27159,9.946,25635,9.388,864401,263095,601306,4.874,16.013,730964,270234,460730,5.006,13.541,133437,2.472,27.082,16278,16736,110764
2000,18,103917,133744,2650527,2609620,12565,9.400,12418,9.290,383126,117374,265752,4.498,14.681,301718,97904,203814,3.752,11.562,81408,3.120,23.124,8125,8395,48893
2000,19,58330,73533,1278461,1264943,6168,8.394,6070,8.260,168206,56579,111627,4.473,13.298,140987,47180,93807,3.730,11.146,27219,2.152,22.291,4095,4228,23225
2000,20,54589,67722,1121805,1110329,6748,9.989,6419,9.502,167986,62099,105887,5.593,15.129,145793,48372,97421,4.357,13.131,22193,1.999,26.261,4195,4293,23394
2000,21,64848,82232,1510509,1487052,8037,9.782,7896,9.610,228381,75376,153005,5.069,15.358,181255,61111,120144,4.110,12.189,47126,3.169,24.378,5182,5318,33547
2000,22,72776,92048,1599173,1587183,9356,10.173,9205,10.008,263330,101737,161593,6.410,16.591,238790,84184,154606,5.304,15.045,24540,1.546,30.090,5993,6204,49833
2000,23,29188,34423,491676,482472,3573,10.457,3067,8.976,72448,23277,49171,4.825,15.016,53971,19615,34356,4.066,11.186,18477,3.830,22.373,2102,2148,10737
2000,24,91954,113892,2064800,2026726,11971,10.545,11230,9.892,349640,111897,237743,5.521,17.251,274240,99276,174964,4.898,13.531,75400,3.720,27.062,7089,7255,42302
2000,25,126848,154260,3047217,2993973,15616,10.194,13460,8.787,492463,151609,340854,5.064,16.448,386100,137607,248493,4.596,12.896,106363,3.553,25.792,8546,8915,63290
2000,26,168501,210764,4040561,4008243,20232,9.612,19693,9.356,615769,201140,414629,5.018,15.363,553205,194749,358456,4.859,13.802,62564,1.561,27.603,12601,12968,87068
2000,27,99240,121775,2385809,2351951,11932,9.859,10433,8.620,347561,105161,242400,4.471,14.778,279449,83439,196010,3.548,11.882,68112,2.896,23.763,6870,7079,43306
2000,28,43283,54561,956233,950812,5598,10.251,5696,10.430,134175,47926,86249,5.041,14.112,122713,42325,80388,4.451,12.906,11462,1.205,25.812,3856,3953,22810
2000,29,104604,130745,2386936,2365111,13467,10.326,12813,9.825,353881,114160,239721,4.827,14.963,310949,101234,209715,4.280,13.147,42932,1.815,26.295,8636,8839,48822
2000,30,23951,27768,299623,294184,3120,11.317,2721,9.870,48862,15990,32872,5.435,16.609,37945,13719,24226,4.663,12.898,10917,3.711,25.797,1852,1889,8267
2000,31,36469,44513,751125,739298,4183,9.452,3672,8.297,110943,37152,73791,5.025,15.007,87604,26415,61189,3.573,11.850,23339,3.157,23.699,2410,2489,12371
2000,32,34260,42033,916559,890325,6498,15.714,5133,12.413,178642,63520,115122,7.134,20.065,125769,44307,81462,4.977,14.126,52873,5.939,28.252,3320,3384,22270
2000,33,28524,33716,559614,546722,3328,9.910,3061,9.115,92007,28580,63427,5.228,16.829,66762,23249,43513,4.252,12.211,25245,4.618,24.423,1984,2047,12361
2000,34,175886,206772,3546424,3497912,22170,10.761,20676,10.036,591232,185256,405976,5.296,16.902,495430,178464,316966,5.102,14.164,95802,2.739,28.327,13383,13666,80353
2000,35,31144,38395,551166,546284,4248,11.061,4267,11.111,90402,31119,59283,5.696,16.549,80875,28948,51927,5.299,14.805,9527,1.744,29.609,2826,2894,15702
2000,36,364323,430324,7276801,7169653,45421,10.608,41091,9.597,1131601,366247,765354,5.108,15.783,914986,326723,588263,4.557,12.762,216615,3.021,25.524,27265,27876,161881
2000,37,144609,184132,3400393,3363557,19706,10.753,17980,9.811,518945,172489,346456,5.128,15.428,446941,157430,289511,4.680,13.288,72004,2.141,26.576,11805,12161,72295
2000,38,15253,18205,256079,253848,1410,7.721,1522,8.335,33031,9770,23261,3.849,13.012,28442,8919,19523,3.514,11.204,4589,1.808,22.409,1099,1130,5990
2000,39,189597,246441,4991047,4923057,21826,8.868,21191,8.610,754285,237050,517235,4.815,15.321,621465,191388,430077,3.888,12.624,132820,2.698,25.247,13375,13891,87905
2000,40,61961,76656,1200911,1179526,8116,10.594,8028,10.479,205750,73369,132381,6.220,17.443,163543,58561,104982,4.965,13.865,42207,3.578,27.730,5283,5448,30995
2000,41,73635,88810,1345913,1334617,9918,11.196,9462,10.682,219169,80860,138309,6.059,16.422,196318,65136,131182,4.881,14.710,22851,1.712,29.419,6270,6464,34050
2000,42,212797,268791,5063424,5006871,23793,8.872,22591,8.424,735021,242409,492612,4.842,14.680,622035,204580,417455,4.086,12.424,112986,2.257,24.847,14284,14827,88313
2000,44,22353,25395,418821,415199,2436,9.628,2251,8.896,61684,20216,41468,4.869,14.857,54466,19840,34626,4.778,13.118,7218,1.738,26.236,1507,1546,8092
2000,45,69787,88259,1615079,1597843,9679,11.014,8923,10.154,252151,81819,170332,5.121,15.781,219027,71403,147624,4.469,13.708,33124,2.073,27.415,5782,5939,35088
2000,46,18059,21262,307084,303277,1986,9.368,1860,8.774,45677,13575,32102,4.476,15.061,37981,12259,25722,4.042,12.524,7696,2.538,25.047,1274,1320,6063
2000,47,91652,119785,2386703,2357526,12384,10.338,12393,10.346,381129,120856,260274,5.126,16.166,323340,116064,207276,4.923,13.715,57789,2.451,27.430,8001,8256,49212
2000,48,323973,424421,8021020,7873237,49475,11.703,46142,10.915,1468112,508301,959811,6.456,18.647,1175570,426338,749232,5.415,14.931,292542,3.716,29.862,29597,30872,206590
2000,49,38842,47772,910360,896183,6535,13.865,5259,11.158,157017,57348,99669,6.399,17.521,128883,44859,84024,5.006,14.381,28134,3.139,28.763,3545,3625,25401
2000,50,16764,19162,253105,248217,1795,9.394,1686,8.824,37589,12272,25317,4.944,15.144,27748,8626,19122,3.475,11.179,9841,3.965,22.358,1195,1205,5199
2000,51,123010,158347,2908148,2850087,17141,10.888,15298,9.718,491673,166157,325516,5.830,17.251,375571,134732,240839,4.727,13.178,116102,4.074,26.355,9492,9804,56738
2000,53,118696,143974,2236593,2203563,17010,11.863,15825,11.037,386306,126508,259798,5.741,17.531,318146,101139,217007,4.590,14.438,68160,3.093,28.876,10447,10805,56165
2000,54,30287,37769,564251,557029,3451,9.126,3544,9.372,78898,27525,51373,4.941,14.164,64631,20635,43996,3.704,11.603,14267,2.561,23.206,2288,2371,12387
2000,55,102647,127059,2416189,2387418,11473,9.067,10424,8.238,327050,104483,222567,4.376,13.699,269222,87366,181856,3.659,11.277,57828,2.422,22.553,6966,7162,40653
2000,56,13708,15877,174967,172085,1680,10.644,1494,9.465,29135,8920,20215,5.183,16.931,23274,7507,15767,4.362,13.525,5861,3.406,27.049,973,997,4407
2001,01,70622,90726,1607531,1629167,9451,10.389,9944,10.931,232374,94262,138112,5.786,14.263,274296,97963,176333,6.013,16.837,-41922,-2.573,28.527,6417,6718,51009
2001,02,12738,15322,210785,209001,1749,11.410,1762,11.495,35790,10783,25007,5.159,17.124,32366,13195,19171,6.313,15.486,3424,1.638,30.972,1022,1050,5141
2001,04,81664,103385,1944283,1935094,14038,13.679,12524,12.203,356857,135903,220954,7.023,18.441,337672,144239,193433,7.454,17.450,19185,0.991,34.900,7424,7666,52462
2001,05,45630,56532,982479,984796,6138,10.834,6387,11.273,142357,56587,85770,5.746,14.455,146758,51573,95185,5.237,14.902,-4401,-0.447,28.911,4308,4440,28557
2001,06,574491,710061,12925160,12807970,85693,12.135,77892,11.030,2249696,756699,1492997,5.908,17.565,2016533,743186,1273347,5.803,15.744,233163,1.820,31.489,49220,50849,359884
2001,08,100135,121339,1951117,1939165,16504,13.748,13912,11.589,361440,143011,218429,7.375,18.639,336757,129504,207253,6.678,17.366,24683,1.273,34.732,8810,9026,56235
2001,09,69197,83252,1543592,1543262,7714,9.263,7769,9.329,216856,78242,138614,5.070,14.052,215650,77237,138413,5.005,13.974,1206,0.078,27.947,4724,4884,27646
2001,10,17614,21239,384912,381743,2611,12.432,2136,10.171,64016,22935,41081,6.008,16.769,57341,18789,38552,4.922,15.021,6675,1.749,30.042,1283,1321,7915
2001,11,14306,17697,401728,400174,1862,10.565,1715,9.731,61229,22542,38687,5.633,15.301,57593,22858,34735,5.712,14.392,3636,0.909,28.784,920,943,7079
2001,12,308143,382419,6421767,6304503,51975,13.683,46852,12.334,1321420,461297,860123,7.317,20.960,1095619,458760,636859,7.277,17.378,225801,3.582,34.757,29561,30477,189427
2001,13,139809,179630,3428829,3435762,22814,12.775,20729,11.607,563563,217660,345903,6.335,16.403,579407,218992,360415,6.374,16.864,-15844,-0.461,32.806,12489,13131,94079
2001,15,22064,27526,438493,435302,2716,9.925,2393,8.745,58090,19967,38123,4.587,13.345,51907,18120,33787,4.163,11.924,6183,1.420,23.849,1440,1491,8351
2001,16,27875,33054,463250,458730,4201,12.761,3933,11.947,80918,30564,50354,6.663,17.640,72550,27007,45543,5.887,15.815,8368,1.824,31.631,2324,2397,14360
2001,17,219947,273110,5359193,5401028,26301,9.618,26968,9.862,747800,259680,488120,4.808,13.846,832730,284115,548615,5.260,15.418,-84930,-1.572,27.691,16678,17344,116069
2001,18,103152,132825,2578616,2615159,12514,9.392,13347,10.017,332448,114612,217836,4.383,12.712,403874,138871,265003,5.310,15.444,-71426,-2.731,25.425,7981,8291,62136
2001,19,57527,72788,1250437,1259634,5920,8.089,6720,9.182,143715,48054,95661,3.815,11.409,162517,50731,111786,4.027,12.902,-18802,-1.493,22.819,4264,4416,24080
2001,20,54236,67542,1111818,1119999,6683,9.879,6890,10.185,147603,52842,94761,4.718,13.179,164472,57049,107423,5.094,14.685,-16869,-1.506,26.358,4369,4489,25506
2001,21,64685,82040,1487729,1499587,7978,9.714,8159,9.934,200405,67292,133113,4.487,13.364,224493,76298,148195,5.088,14.970,-24088,-1.606,26.728,5048,5240,33536
2001,22,72600,91729,1591625,1596200,9311,10.133,9621,10.471,239944,80698,159246,5.056,15.032,249260,86009,163251,5.388,15.616,-9316,-0.584,30.064,5704,5913,41461
2001,23,29287,34716,494700,493142,3600,10.418,3279,9.489,68619,26172,42447,5.307,13.915,66079,23654,42425,4.797,13.400,2540,0.515,26.799,2214,2246,11391
2001,24,92706,114883,2074102,2067418,12735,11.135,11700,10.230,323883,118786,205097,5.746,15.666,309857,113836,196021,5.506,14.988,14026,0.678,29.975,6929,7314,51051
2001,25,127066,154877,3068191,3054138,15321,9.917,14558,9.423,472328,154753,317575,5.067,15.465,443634,161886,281748,5.301,14.526,28694,0.940,29.051,9064,9315,70932
2001,26,167344,210269,3965150,4005766,20475,9.729,20864,9.913,565987,194152,371835,4.847,14.129,645680,213201,432479,5.322,16.119,-79693,-1.989,28.259,12955,13407,91006
2001,27,99873,123535,2385381,2383758,12973,10.580,11148,9.091,331752,123388,208364,5.176,13.917,329242,109251,219991,4.583,13.812,2510,0.105,27.624,6994,7222,49921
2001,28,42693,54056,921758,940411,5564,10.247,6054,11.149,124427,48346,76081,5.141,13.231,161873,60243,101630,6.406,17.213,-37446,-3.982,26.462,3845,4009,28981
2001,29,103389,130019,2367421,2376674,12664,9.716,13316,10.216,331704,115026,216678,4.840,13.957,349781,118856,230925,5.001,14.717,-18077,-0.761,27.913,8664,8891,53494
2001,30,24197,28135,303391,301564,3105,11.107,2745,9.819,46767,15998,30769,5.305,15.508,42891,14626,28265,4.850,14.223,3876,1.285,28.446,1768,1798,9168
2001,31,36530,44743,739753,744664,4230,9.472,4057,9.085,98806,38367,60439,5.152,13.269,108979,37930,71049,5.094,14.635,-10173,-1.366,26.537,2502,2594,15799
2001,32,34937,42879,936996,926946,6553,15.430,5736,13.506,163557,63917,99640,6.895,17.645,144690,50727,93963,5.472,15.609,18867,2.035,31.219,3643,3737,26658
2001,33,28597,33842,558335,556925,3357,9.939,3223,9.543,77002,27382,49620,4.917,13.826,73804,28363,45441,5.093,13.252,3198,0.574,26.504,2081,2154,12371
2001,34,176775,208459,3609542,3578414,22652,10.910,20999,10.114,599780,199956,399824,5.588,16.761,534703,182916,351787,5.112,14.942,65077,1.819,29.885,13471,13760,81739
2001,35,31119,38410,552680,551669,4394,11.447,4342,11.312,92599,32828,59771,5.951,16.785,90535,33143,57392,6.008,16.411,2064,0.374,32.822,2573,2642,14625
2001,36,366559,432891,7254199,7252340,46020,10.668,43010,9.970,1035147,358522,676625,4.944,14.273,1032635,374080,658555,5.158,14.239,2512,0.035,28.477,27426,28019,173326
2001,37,145560,185569,3428720,3414481,20754,11.230,19244,10.413,545714,191892,353822,5.620,15.982,513375,179531,333844,5.258,15.035,32339,0.947,30.070,11856,12373,77363
2001,38,15173,18197,257218,256313,1503,8.252,1538,8.444,32269,12060,20209,4.705,12.590,30621,9501,21120,3.707,11.947,1648,0.643,23.893,1025,1043,6239
2001,39,187923,245337,4882569,4935337,21651,8.810,22512,9.160,640430,227120,413310,4.602,12.976,746129,237618,508511,4.815,15.118,-105699,-2.142,25.953,13613,14265,97784
2001,40,61749,76709,1208541,1205647,8138,10.612,8092,10.552,189030,68998,120032,5.723,15.679,183164,68334,114830,5.668,15.192,5866,0.487,30.384,5154,5289,31339
2001,41,73798,89442,1358303,1351238,10496,11.780,9811,11.011,218195,81532,136663,6.034,16.148,203519,68197,135322,5.047,15.062,14676,1.086,30.123,6292,6482,33262
2001,42,212314,269354,5062248,5062240,24676,9.174,23936,8.899,701166,253091,448075,5.000,13.851,697778,242638,455140,4.793,13.784,3388,0.067,27.568,14531,15237,107798
2001,44,22309,25403,413041,415445,2379,9.372,2342,9.226,51935,16914,35021,4.071,12.501,56072,16254,39818,3.912,13.497,-4137,-0.996,25.002,1518,1559,8657
2001,45,69644,88377,1599476,1607414,9721,11.008,9589,10.858,238541,86659,151882,5.391,14.840,253287,87895,165392,5.468,15.757,-14746,-0.917,29.680,6023,6283,43604
2001,46,18073,21361,313873,310659,2046,9.593,1982,9.293,45690,21363,24327,6.877,14.707,39987,12437,27550,4.003,12.872,5703,1.836,25.743,1281,1305,6619
2001,47,90581,118932,2349963,2366606,12427,10.415,13194,11.058,351974,124340,227634,5.254,14.873,384575,140359,244216,5.931,16.250,-32601,-1.378,29.745,7957,8325,67968
2001,48,325723,427939,8114051,8074085,51187,12.009,47768,11.207,1440551,543524,897027,6.732,17.842,1360395,545080,815315,6.751,16.849,80156,0.993,33.698,29108,30282,228122
2001,49,39826,48735,911180,911890,7045,14.592,6136,12.709,161940,61929,100011,6.791,17.759,165489,65848,99641,7.221,18.148,-3549,-0.389,35.517,3617,3713,29476
2001,50,16646,19108,253242,251507,1669,8.737,1660,8.690,32217,10185,22032,4.050,12.810,28829,10012,18817,3.981,11.463,3388,1.347,22.925,1155,1169,5628
2001,51,123941,159582,2937050,2926873,17340,10.911,16023,10.082,472997,175256,297741,5.988,16.160,452615,149896,302719,5.121,15.464,20382,0.696,30.928,9375,9748,61092
2001,53,118927,144751,2249099,2243013,17153,11.882,16375,11.343,358549,125445,233104,5.593,15.985,347138,115472,231666,5.148,15.476,11411,0.509,30.953,10319,10593,59412
2001,54,29670,37114,556939,559640,3225,8.619,3830,10.236,74569,23635,50934,4.223,13.324,79957,28081,51876,5.018,14.287,-5388,-0.963,26.649,2401,2455,11408
2001,55,102370,127047,2383839,2399637,11125,8.757,11111,8.746,282598,89755,192843,3.740,11.777,314526,101136,213390,4.215,13.107,-31928,-1.331,23.553,7056,7394,47187
2001,56,13848,16042,178785,176908,1812,11.349,1661,10.403,29095,10156,18939,5.741,16.446,25440,8781,16659,4.964,14.380,3655,2.066,28.761,1038,1055,4879
2002,01,70694,91379,1580317,1595811,10230,11.219,9843,10.794,256717,99500,157217,6.235,16.087,288148,93056,195092,5.831,18.057,-31431,-1.970,32.174,6045,6212,47785
2002,02,12850,15628,213687,212756,2131,13.762,1844,11.909,39775,15542,24233,7.305,18.695,37983,12250,25733,5.758,17.853,1792,0.842,35.706,1042,1055,6586
2002,04,82247,105214,1936027,1942994,14864,14.243,13155,12.605,387471,159163,228308,8.192,19.942,401602,136844,264758,7.043,20.669,-14131,-0.727,39.884,7875,8108,62325
2002,05,46049,57468,969782,978952,6875,12.042,6124,10.726,150739,53850,96889,5.501,15.398,169908,58834,111074,6.010,17.356,-19169,-1.958,30.796,3908,3999,35571
2002,06,578004,720469,12637954,12833080,94942,13.256,86401,12.064,2293305,931432,1361873,7.258,17.870,2686108,901415,1784693,7.024,20.931,-392803,-3.061,35.741,52847,54512,467080
2002,08,100738,122656,1890677,1927104,16601,13.585,15693,12.842,339190,137758,201432,7.148,17.601,412835,137702,275133,7.146,21.423,-73645,-3.822,35.202,9349,9591,63061
2002,09,68651,83154,1539918,1545314,8325,9.992,8651,10.383,236302,89969,146333,5.822,15.292,247219,79645,167574,5.154,15.998,-10917,-0.706,30.583,5055,5135,34573
2002,10,17520,21571,384796,386009,2694,12.561,2448,11.414,66395,31767,34628,8.230,17.200,68315,22704,45611,5.882,17.698,-1920,-0.497,34.401,1411,1461,9156
2002,11,14637,18135,415382,414741,2204,12.225,1992,11.049,68978,26228,42750,6.324,16.632,67548,23441,44107,5.652,16.287,1430,0.345,32.574,992,1014,11267
2002,12,313450,390766,6351738,6404041,56589,14.624,48982,12.658,1218577,498365,720212,7.782,19.028,1324217,498165,826052,7.779,20.678,-105640,-1.650,38.057,30352,31144,243169
2002,13,141434,182177,3374002,3418005,24274,13.403,22130,12.219,567961,238889,329072,6.989,16.617,656309,230651,425658,6.748,19.202,-88348,-2.585,33.233,12802,13161,107377
2002,15,22232,27853,439316,441459,3076,11.090,2845,10.257,66871,28123,38748,6.370,15.148,70973,23847,47126,5.402,16.077,-4102,-0.929,30.295,1645,1685,12515
2002,16,28186,33650,452618,458395,4466,13.374,3950,11.829,82057,34385,47672,7.501,17.901,93035,30699,62336,6.697,20.296,-10978,-2.395,35.802,2305,2355,18538
2002,17,218472,273151,5170439,5279584,29573,10.812,30292,11.075,782102,312925,469177,5.927,14.814,1003155,334750,668405,6.340,19.001,-221053,-4.187,29.627,17433,18079,165476
2002,18,103401,133927,2522809,2560753,14333,10.728,13675,10.236,375749,152335,223414,5.949,14.673,450568,135179,315389,5.279,17.595,-74819,-2.922,29.347,7957,8301,63168
2002,19,57291,72795,1230719,1245921,6798,9.324,7023,9.633,162213,64010,98203,5.138,13.020,192428,60327,132101,4.842,15.445,-30215,-2.425,26.039,4034,4175,31545
2002,20,54126,67894,1102940,1110624,7406,10.919,7270,10.719,174508,73489,101019,6.617,15.713,190376,61116,129260,5.503,17.141,-15868,-1.429,31.425,4358,4494,31767
2002,21,64547,82739,1463217,1478202,8818,10.688,8340,10.109,218528,83461,135067,5.646,14.783,248314,72991,175323,4.938,16.798,-29786,-2.015,29.567,5081,5206,34981
2002,22,73080,92792,1574258,1587303,10166,11.004,9343,10.114,258530,104107,154423,6.559,16.287,286327,96342,189985,6.070,18.039,-27797,-1.751,32.575,5660,5880,50110
2002,23,29167,34941,486991,493809,3865,11.075,3780,10.831,70035,28749,41286,5.822,14.183,83652,28001,55651,5.670,16.940,-13617,-2.758,28.365,2321,2354,15652
2002,24,93687,116876,2060371,2074656,14125,12.172,12460,10.737,335681,136932,198749,6.600,16.180,364724,125289,239435,6.039,17.580,-29043,-1.400,32.360,7074,7301,61376
2002,25,126399,155574,2981212,3035902,16626,10.694,16415,10.558,456030,176030,280000,5.798,15.021,566822,186779,380043,6.152,18.671,-110792,-3.649,30.042,9869,10092,86799
2002,26,165700,209769,3866699,3923192,22826,10.853,23912,11.370,627760,265962,361798,6.779,16.001,742106,248925,493181,6.345,18.916,-114346,-2.915,32.003,14063,14445,113664
2002,27,99770,124311,2352936,2378779,13882,11.187,13448,10.837,358427,133645,224782,5.618,15.068,409978,135891,274087,5.713,17.235,-51551,-2.167,30.135,7767,7993,60541
2002,28,42948,54615,913775,919681,6219,11.429,5814,10.685,142769,57217,85552,6.221,15.524,155013,52301,102712,5.687,16.855,-12244,-1.331,31.048,3565,3635,25124
2002,29,104132,131587,2335483,2359323,15649,11.947,14450,11.032,371119,150894,220225,6.396,15.730,417319,142093,275226,6.023,17.688,-46200,-1.958,31.460,8672,8907,71145
2002,30,24299,28388,300645,302209,3247,11.466,3110,10.982,50230,19238,30992,6.366,16.621,53320,17939,35381,5.936,17.643,-3090,-1.022,33.242,1833,1855,9394
2002,31,36595,45144,739838,740180,4607,10.237,4324,9.608,114465,45848,68617,6.194,15.464,115276,35089,80187,4.741,15.574,-811,-0.110,30.929,2572,2626,17514
2002,32,35544,44158,934566,937377,7048,16.181,5848,13.426,185206,81308,103898,8.674,19.758,191667,61742,129925,6.587,20.447,-6461,-0.689,39.516,3617,3686,27963
2002,33,28458,33981,549603,556477,3572,10.517,3535,10.409,80112,31460,48652,5.653,14.396,93898,29814,64084,5.358,16.874,-13786,-2.477,28.793,2173,2227,16050
2002,34,176366,209467,3579307,3602008,24187,11.561,23685,11.321,605761,219259,386502,6.087,16.817,650510,209027,441483,5.803,18.060,-44749,-1.242,33.635,14560,14826,99432
2002,35,31273,38668,553329,554507,4653,12.056,4505,11.673,98950,40643,58307,7.330,17.845,101549,34699,66850,6.258,18.313,-2599,-0.469,35.689,2573,2632,16998
2002,36,367053,435651,7172846,7257360,50863,11.694,49464,11.372,1178363,492853,685510,6.791,16.237,1348832,500408,848424,6.895,18.586,-170469,-2.349,32.474,29835,30409,222807
2002,37,145758,187176,3326047,3385087,21797,11.679,20711,11.097,510454,212108,298346,6.266,15.079,626194,202998,423196,5.997,18.499,-115740,-3.419,30.159,12305,12670,91595
2002,38,15035,18233,254501,256477,1655,9.073,1669,9.150,36474,16106,20368,6.280,14.221,40312,13314,26998,5.191,15.718,-3838,-1.496,28.442,1015,1034,7071
2002,39,186693,245380,4730322,4817236,24285,9.882,25022,10.182,710232,270114,440118,5.607,14.744,882826,270577,612249,5.617,18.326,-172594,-3.583,29.487,14222,14710,125096
2002,40,62304,77527,1190934,1201449,8876,11.494,8269,10.708,202639,79212,123427,6.593,16.866,223771,80569,143202,6.706,18.625,-21132,-1.759,33.732,4955,5101,38140
2002,41,73514,89826,1327686,1346317,10672,11.888,10556,11.759,214316,82412,131904,6.121,15.919,251474,83188,168286,6.179,18.679,-37158,-2.760,31.837,6390,6536,45034
2002,42,211987,270515,5012916,5056824,26585,9.834,26236,9.705,759703,297330,462373,5.880,15.023,848172,298906,549266,5.911,16.773,-88469,-1.749,30.047,15044,15611,126484
2002,44,22220,25535,417327,416008,2663,10.441,2601,10.198,65378,27621,37757,6.640,15.716,62149,19271,42878,4.632,14.939,3229,0.776,29.879,1562,1578,9639
2002,45,70000,89220,1544479,1577804,10370,11.663,9752,10.968,227564,87550,140014,5.549,14.423,294421,91208,203213,5.781,18.660,-66857,-4.237,28.846,5930,6086,46829
2002,46,18303,21775,301274,307792,2407,11.149,2037,9.435,43403,16291,27112,5.293,14.101,56168,19093,37075,6.203,18.249,-12765,-4.147,28.203,1293,1313,9281
2002,47,90214,119152,2299658,2330798,13301,11.152,13540,11.352,363869,133360,230509,5.722,15.611,427140,139103,288037,5.968,18.326,-63271,-2.715,31.223,7926,8155,62211
2002,48,328305,434109,7967147,8064212,55336,12.823,50205,11.634,1482983,637789,845194,7.909,18.390,1678150,567954,1110196,7.043,20.810,-195167,-2.420,36.779,29649,30759,249211
2002,49,40811,50046,905564,909278,7555,15.285,6321,12.788,165163,65657,99506,7.221,18.164,172384,56910,115474,6.259,18.958,-7221,-0.794,36.328,3694,3767,30124
2002,50,16553,19075,254033,255491,1828,9.549,1965,10.265,37186,13895,23291,5.439,14.555,39986,13327,26659,5.216,15.651,-2800,-1.096,29.109,1174,1200,6350
2002,51,125311,162124,2924310,2941571,19178,11.905,17106,10.619,488547,195722,292825,6.654,16.608,522863,186868,335995,6.353,17.775,-34316,-1.167,33.217,9691,10019,83760
2002,53,118333,145340,2157649,2207995,18191,12.525,17995,12.390,342284,140424,201860,6.360,15.502,444264,140012,304252,6.341,20.121,-101980,-4.619,31.004,10945,11194,74239
2002,54,29398,37039,565737,563391,3630,9.774,3832,10.318,89837,28494,61343,5.058,15.946,85090,26766,58324,4.751,15.103,4747,0.843,30.206,2341,2375,14298
2002,55,102092,127614,2363207,2382572,12790,10.031,12571,9.859,334384,131424,202960,5.516,14.035,374618,112050,262568,4.703,15.723,-40234,-1.689,28.069,7549,7757,56175
2002,56,14126,16382,178231,178227,2049,12.622,1752,10.792,33613,13441,20172,7.542,18.860,33680,12388,21292,6.951,18.897,-67,-0.038,37.719,1060,1071,5822
2003,01,71006,91900,1599218,1589981,9549,10.423,8975,9.797,251048,77113,173935,4.850,15.789,231733,76951,154782,4.840,14.575,19315,1.215,29.149,5913,5989,34115
2003,02,13072,15939,218143,215288,1968,12.471,1651,10.462,40171,14144,26027,6.570,18.659,34099,10510,23589,4.882,15.839,6072,2.820,31.678,953,976,4872
2003,04,83813,107078,1978714,1958258,14433,13.600,12525,11.802,388711,139786,248925,7.138,19.850,350729,134270,216459,6.857,17.910,37982,1.940,35.821,7831,7958,53864
2003,05,46569,58325,979974,974938,6479,11.193,5595,9.666,141289,47572,93717,4.879,14.492,131369,42282,89087,4.337,13.475,9920,1.018,26.949,3786,3851,18434
2003,06,587014,729162,12775745,12706948,90613,12.504,81689,11.272,2240321,764063,1476258,6.013,17.631,2098693,712902,1385791,5.610,16.516,141628,1.115,33.032,52433,54134,366395
2003,08,102361,124426,1874789,1882155,16641,13.473,14820,11.998,315801,122815,192986,6.525,16.779,330859,118119,212740,6.276,17.579,-15058,-0.800,33.557,9225,9373,55488
2003,09,68267,82588,1538320,1540548,7486,9.035,8023,9.683,216064,67063,149001,4.353,14.025,220906,73957,146949,4.801,14.339,-4842,-0.314,28.050,4869,4941,28441
2003,10,17786,21876,382270,383466,2432,11.202,2102,9.682,51419,17646,33773,4.602,13.409,54173,19079,35094,4.975,14.127,-2754,-0.718,26.818,1284,1307,7574
2003,11,14602,18050,414213,414693,1738,9.608,1817,10.045,55247,17255,37992,4.161,13.322,56231,17991,38240,4.338,13.560,-984,-0.237,26.645,952,962,5525
2003,12,323475,401252,6456922,6397608,59109,14.928,48512,12.252,1232515,450944,781571,7.049,19.265,1112023,449684,662339,7.029,17.382,120492,1.883,34.764,31927,32468,194772
2003,13,144271,185204,3357845,3364698,23983,13.058,20893,11.376,529321,195152,334169,5.800,15.732,543463,185002,358461,5.498,16.152,-14142,-0.420,31.463,12790,13097,78051
2003,15,22659,28252,457851,448417,2896,10.325,2490,8.877,70615,21220,49395,4.732,15.748,51411,19806,31605,4.417,11.465,19204,4.283,22.930,1505,1555,10286
2003,16,29108,34668,465173,459007,4624,13.540,3587,10.504,77702,27012,50690,5.885,16.928,65942,22047,43895,4.803,14.366,11760,2.562,28.732,2288,2329,10437
2003,17,219808,274893,5189066,5179506,28628,10.449,26798,9.781,762340,243429,518911,4.700,14.718,743888,250881,493007,4.844,14.362,18452,0.356,28.724,16439,16794,113814
2003,18,103723,134433,2539614,2531171,12962,9.662,12412,9.252,371221,117143,254078,4.628,14.666,353741,121721,232020,4.809,13.975,17480,0.691,27.951,7740,7982,51832
2003,19,57588,73045,1227592,1228959,6802,9.330,6518,8.941,154478,53634,100844,4.364,12.570,157268,48421,108847,3.940,12.797,-2790,-0.227,25.140,3851,3938,21105
2003,20,54423,68207,1110597,1107790,6907,10.154,6534,9.606,159133,59292,99841,5.352,14.365,153515,51935,101580,4.688,13.858,5618,0.507,27.716,4102,4188,25278
2003,21,64575,82957,1464781,1463801,7971,9.623,7719,9.319,205672,67668,138004,4.623,14.051,204856,64974,139882,4.439,13.995,816,0.056,27.990,4968,5109,30862
2003,22,73706,93318,1594923,1584903,9285,9.980,8718,9.371,248850,79673,169177,5.027,15.701,228220,74995,153225,4.732,14.400,20630,1.302,28.799,5571,5680,38635
2003,23,29527,35353,489004,487660,3671,10.448,3236,9.210,68447,24407,44040,5.005,14.036,65973,22097,43876,4.531,13.528,2474,0.507,27.057,2066,2114,11464
2003,24,95298,118429,2074815,2067209,12992,11.043,11422,9.709,310876,102143,208733,4.941,15.038,296370,92404,203966,4.470,14.337,14506,0.702,28.673,6875,7050,40121
2003,25,128598,157523,2962768,2974228,17002,10.862,15014,9.592,421153,133552,287601,4.490,14.160,445096,161688,283408,5.436,14.965,-23943,-0.805,28.320,8924,9090,58652
2003,26,165834,210058,3848588,3857795,21326,10.160,20995,10.003,573301,192408,380893,4.988,14.861,592932,184617,408315,4.786,15.370,-19631,-0.509,29.722,13037,13435,90907
2003,27,101321,126122,2365843,2358254,13859,11.070,12008,9.591,347959,124545,223414,5.281,14.755,332939,107477,225462,4.557,14.118,15020,0.637,28.236,7182,7281,41706
2003,28,43287,55044,917176,915311,5826,10.627,5384,9.821,140447,49711,90736,5.431,15.344,136950,45803,91147,5.004,14.962,3497,0.382,29.924,3521,3568,21783
2003,29,105773,133443,2368068,2351684,15239,11.502,13328,10.060,341601,102281,239320,4.349,14.526,309527,102623,206904,4.364,13.162,32074,1.364,26.324,8663,8888,49685
2003,30,24913,29022,305071,302778,3382,11.785,2733,9.523,47307,16897,30410,5.581,15.624,42805,13535,29270,4.470,14.137,4502,1.487,28.275,1746,1762,7569
2003,31,36950,45617,757679,748687,4445,9.798,3948,8.702,117158,36461,80697,4.870,15.648,99360,31488,67872,4.206,13.271,17798,2.377,26.542,2438,2477,12716
2003,32,37047,45908,972324,954188,7337,16.313,5475,12.173,174194,61128,113066,6.406,18.256,138058,45175,92883,4.734,14.469,36136,3.787,28.937,3561,3607,23415
2003,33,28606,34186,542754,546285,3503,10.278,3293,9.662,74871,25761,49110,4.716,13.705,81453,23703,57750,4.339,14.910,-6582,-1.205,27.411,2176,2218,12749
2003,34,177000,210144,3569522,3574930,23433,11.170,22711,10.826,558292,180107,378185,5.038,15.617,569991,192072,377919,5.373,15.944,-11699,-0.327,31.234,14742,14953,94302
2003,35,31707,39114,571402,562222,4446,11.434,3987,10.253,99033,36400,62633,6.474,17.615,81121,31072,50049,5.527,14.429,17912,3.186,28.857,2385,2438,13639
2003,36,372011,440366,7260392,7211712,49798,11.371,44948,10.263,1104105,346896,757209,4.810,15.310,1005400,337349,668051,4.678,13.941,98705,1.369,27.882,30318,30807,166882
2003,37,147003,188828,3346803,3336883,20986,11.164,19286,10.260,516969,183223,333746,5.491,15.493,498544,167860,330684,5.030,14.940,18425,0.552,29.881,11863,12079,69221
2003,38,15100,18278,260378,257300,1503,8.236,1447,7.929,35360,9736,25624,3.784,13.743,29254,9763,19491,3.794,11.370,6106,2.373,22.739,888,893,4980
2003,39,186493,245194,4743234,4738117,22736,9.270,22856,9.319,670464,211817,458647,4.470,14.150,662503,205978,456525,4.347,13.982,7961,0.168,27.965,13617,14040,88881
2003,40,62700,78033,1173697,1182657,8196,10.540,7649,9.837,175934,58419,117515,4.940,14.876,193710,61418,132292,5.193,16.379,-17776,-1.503,29.752,5098,5150,30190
2003,41,74880,91294,1330265,1327826,10819,11.951,9293,10.265,203501,62061,141440,4.674,15.326,199260,69964,129296,5.269,15.006,4241,0.319,30.013,5793,5890,29909
2003,42,212696,271706,4987016,4998700,25290,9.329,24031,8.865,693267,224882,468385,4.499,13.869,717850,230331,487519,4.608,14.361,-24583,-0.492,27.738,14676,15129,95997
2003,44,22490,25792,422085,419419,2705,10.543,2433,9.483,59293,18337,40956,4.372,14.137,53561,16289,37272,3.884,12.770,5732,1.367,25.541,1485,1530,7852
2003,45,71019,90450,1554132,1549298,10182,11.336,8928,9.940,242809,92509,150300,5.971,15.672,233940,84277,149663,5.440,15.100,8869,0.572,30.199,5701,5787,37559
2003,46,18455,21854,303187,302383,2139,9.809,2046,9.382,41325,12887,28438,4.262,13.666,39700,14344,25356,4.744,13.129,1625,0.537,26.258,1253,1271,6418
2003,47,90549,119609,2293210,2295989,12818,10.739,12326,10.326,350127,128979,221148,5.618,15.250,355816,117570,238246,5.121,15.497,-5689,-0.248,30.499,7590,7807,47789
2003,48,332231,438204,7992684,7979457,52590,12.059,48364,11.090,1381901,503929,877972,6.315,17.318,1351810,516333,835477,6.471,16.941,30091,0.377,33.882,29849,30643,213000
2003,49,42286,51514,900435,902359,7729,15.223,6247,12.304,154102,63532,90570,7.041,17.078,156899,59974,96925,6.646,17.388,-2797,-0.310,34.155,3907,3985,30121
2003,50,16645,19289,252225,253069,1891,9.862,1663,8.673,33868,10769,23099,4.255,13.383,35831,13045,22786,5.155,14.159,-1963,-0.776,26.766,1055,1078,6373
2003,51,127425,164659,2932633,2927723,18646,11.414,16052,9.826,441325,150214,291111,5.131,15.074,433121,150029,283092,5.124,14.794,8204,0.280,29.588,9480,9798,58359
2003,53,120187,146989,2204609,2193916,17917,12.260,16227,11.103,353893,114678,239215,5.227,16.131,333621,114028,219593,5.197,15.207,20272,0.924,30.413,10066,10224,48482
2003,54,29237,36979,563717,564562,3489,9.431,3522,9.520,79017,29775,49242,5.274,13.996,80126,24382,55744,4.319,14.193,-1109,-0.196,27.992,2183,2314,13750
2003,55,102120,127864,2386814,2374260,11757,9.206,11452,8.967,318497,105179,213318,4.430,13.415,293173,88963,204210,3.747,12.348,25324,1.067,24.696,7187,7303,40292
2003,56,14339,16593,182237,180232,1892,11.476,1680,10.190,31383,9935,21448,5.512,17.413,27348,9395,17953,5.213,15.174,4035,2.239,30.348,1061,1082,5121
2004,01,71887,93046,1638483,1619095,9679,10.467,8532,9.227,251736,82499,169237,5.095,15.548,213970,72693,141277,4.490,13.215,37766,2.333,26.431,5607,5685,35765
2004,02,13398,16263,223947,221022,1940,12.049,1616,10.037,35215,9626,25589,4.355,15.933,29480,10803,18677,4.888,13.338,5735,2.595,26.676,989,1022,4951
2004,04,86329,110284,2047476,2011644,14870,13.679,11713,10.775,373713,130420,243293,6.483,18.577,302108,120665,181443,5.998,15.018,71605,3.560,30.036,7404,7616,49765
2004,05,47225,59151,995445,987997,6292,10.712,5471,9.314,144904,48238,96666,4.882,14.666,130640,45481,85159,4.603,13.223,14264,1.444,26.445,3793,3853,20642
2004,06,595745,738839,12954769,12861890,90479,12.325,80970,11.030,2143405,731859,1411546,5.690,16.665,1969823,729496,1240327,5.672,15.315,173582,1.350,30.630,52730,54247,375187
2004,08,104204,126690,1893383,1882770,16624,13.240,14366,11.441,304165,114981,189184,6.107,16.155,283675,103430,180245,5.494,15.067,20490,1.088,30.134,9215,9361,52634
2004,09,68835,83500,1535978,1537170,8035,9.674,7147,8.605,202080,66465,135615,4.324,13.146,203874,66707,137167,4.340,13.263,-1794,-0.117,26.292,4575,4631,25974
2004,10,18172,22433,392851,387712,2619,11.825,2050,9.256,60462,23230,37232,5.992,15.595,50122,19457,30665,5.018,12.928,10340,2.667,25.855,1277,1295,7483
2004,11,14880,18482,423307,418801,2115,11.577,1689,9.245,59027,20324,38703,4.853,14.094,49772,14963,34809,3.573,11.884,9255,2.210,23.769,963,994,6286
2004,12,340394,420014,6669343,6594140,66227,16.126,47551,11.579,1252645,446682,805963,6.774,18.996,1111125,442164,668961,6.705,16.850,141520,2.146,33.700,31787,32539,211948
2004,13,148403,190007,3430488,3396478,24143,12.868,19370,10.324,561122,195645,365477,5.760,16.521,493711,171983,321728,5.064,14.536,67411,1.985,29.072,12387,12600,76255
2004,15,23118,28811,471260,464500,2891,10.131,2341,8.204,63838,20068,43770,4.320,13.743,50665,15748,34917,3.390,10.907,13173,2.836,21.815,1521,1558,8831
2004,16,30213,35852,484948,475043,4678,13.267,3493,9.907,84506,39256,45250,8.264,17.789,64484,22781,41703,4.796,13.574,20022,4.215,27.149,2193,2220,11841
2004,17,222620,277919,5201754,5196314,29055,10.511,26041,9.421,727879,226186,501693,4.353,14.008,714700,239818,474882,4.615,13.754,13179,0.254,27.508,16196,16847,117068
2004,18,104815,136155,2581485,2560900,13358,9.873,11642,8.605,353655,113383,240272,4.427,13.810,311205,99820,211385,3.898,12.152,42450,1.658,24.304,7631,7877,51448
2004,19,58003,73503,1243540,1235275,6543,8.929,6091,8.312,159112,46984,112128,3.804,12.881,142148,47511,94637,3.846,11.507,16964,1.373,23.015,3910,3992,21351
2004,20,55135,68927,1119932,1115144,6921,10.096,6170,9.001,149660,53288,96372,4.779,13.421,140617,45021,95596,4.037,12.610,9043,0.811,25.220,3956,4040,22794
2004,21,65210,83732,1484243,1474910,8157,9.787,7383,8.858,207997,69765,138232,4.730,14.102,189202,68594,120608,4.651,12.828,18795,1.274,25.656,4788,4938,34641
2004,22,74521,94256,1618244,1607203,9249,9.862,8304,8.854,239928,73141,166787,4.551,14.928,218615,66512,152103,4.138,13.602,21313,1.326,27.204,5425,5549,36408
2004,23,29982,35870,495364,492032,3686,10.350,3173,8.910,61208,19372,41836,3.937,12.440,54535,18811,35724,3.823,11.084,6673,1.356,22.167,2163,2199,11674
2004,24,97483,120843,2141733,2109901,13443,11.235,11055,9.240,327119,106310,220809,5.039,15.504,262642,94443,168199,4.476,12.448,64477,3.056,24.896,6946,7063,42581
2004,25,127400,156572,2975392,2970743,15659,9.970,16638,10.593,385000,131125,253875,4.414,12.960,376736,118740,257996,3.997,12.682,8264,0.278,25.363,11706,11865,56776
2004,26,166914,210610,3862487,3855234,21026,9.996,20512,9.751,543912,193643,350269,5.023,14.108,531240,189146,342094,4.906,13.780,12672,0.329,27.559,12658,13267,94097
2004,27,103298,128468,2378613,2373391,13910,10.926,11591,9.105,310765,96655,214110,4.072,13.094,300516,101843,198673,4.291,12.662,10249,0.432,25.324,7247,7420,45541
2004,28,43687,55622,930640,924018,5639,10.191,5063,9.150,133836,45209,88627,4.893,14.484,119917,40934,78983,4.430,12.978,13919,1.506,25.956,3401,3460,19481
2004,29,108251,136282,2395278,2382840,15934,11.815,13101,9.714,342178,119468,222710,5.014,14.360,317669,113748,203921,4.774,13.332,24509,1.029,26.663,8788,8898,49707
2004,30,25768,29898,315419,310158,3707,12.586,2819,9.571,48884,16273,32611,5.247,15.761,38142,15544,22598,5.012,12.298,10742,3.463,24.595,1787,1818,8566
2004,31,37311,46003,755726,756494,4225,9.222,3844,8.391,93588,32235,61353,4.261,12.371,94825,24360,70465,3.220,12.535,-1237,-0.164,24.743,2483,2543,13745
2004,32,38714,47884,1025102,999143,7585,16.175,5601,11.944,184882,67486,117396,6.754,18.504,132966,52892,80074,5.294,13.308,51916,5.196,26.616,3671,3775,28160
2004,33,29118,34827,551537,547300,3704,10.734,3064,8.879,69385,22510,46875,4.113,12.678,61269,20642,40627,3.772,11.195,8116,1.483,22.390,2057,2106,11837
2004,34,179444,211701,3603895,3591910,23969,11.362,22485,10.658,558725,175178,383547,4.877,15.555,536840,206176,330664,5.740,14.946,21885,0.609,29.892,14359,14523,88618
2004,35,32264,39725,582433,576869,4427,11.230,3816,9.680,92535,32074,60461,5.560,16.041,81333,29665,51668,5.142,14.099,11202,1.942,28.198,2430,2461,12774
2004,36,377046,446172,7357609,7328004,51882,11.703,46158,10.412,1066424,353266,713158,4.821,14.553,1007683,333706,673977,4.554,13.751,58741,0.802,27.502,31177,31617,174918
2004,37,150189,192477,3369619,3355468,21506,11.279,17885,9.380,494898,166096,328802,4.950,14.749,469702,156987,312715,4.679,13.998,25196,0.751,27.996,11380,11631,73252
2004,38,15370,18569,266578,263444,1645,8.931,1347,7.313,33375,10418,22957,3.955,12.669,27110,10199,16911,3.871,10.291,6265,2.378,20.581,884,890,4714
2004,39,187034,246380,4727436,4735918,22742,9.252,21594,8.785,614658,202260,412398,4.271,12.979,631860,223992,407868,4.730,13.342,-17202,-0.363,25.957,13454,13941,101492
2004,40,63591,79188,1187202,1180573,8388,10.670,7234,9.202,177956,59452,118504,5.036,15.074,164883,54548,110335,4.620,13.966,13073,1.107,27.933,4771,4883,28127
2004,41,76341,93071,1348785,1340291,10816,11.732,9060,9.827,191546,68177,123369,5.087,14.291,174645,65104,109541,4.857,13.030,16901,1.261,26.061,5878,5978,31866
2004,42,215154,274326,5049211,5019342,25432,9.315,22840,8.365,673113,207523,465590,4.134,13.410,615228,212411,402817,4.232,12.257,57885,1.153,24.514,14353,14655,91804
2004,44,23092,26519,436046,429917,2928,11.195,2200,8.411,62326,19384,42942,4.509,14.497,50322,16281,34041,3.787,11.705,12004,2.792,23.410,1502,1509,8294
2004,45,72456,92228,1571520,1563961,10250,11.222,8478,9.282,224819,79055,145764,5.055,14.375,210789,70594,140195,4.514,13.478,14030,0.897,26.956,5577,5680,35914
2004,46,18806,22265,312194,307472,2229,10.103,1825,8.272,45177,13824,31353,4.496,14.693,35573,12565,23008,4.087,11.570,9604,3.124,23.139,1188,1195,5185
2004,47,92164,121544,2338915,2317261,12930,10.723,11012,9.132,344388,115919,228469,5.002,14.862,301308,100447,200861,4.335,13.003,43080,1.859,26.006,7069,7272,45852
2004,48,337218,445131,8091970,8042167,53168,12.037,46298,10.482,1351666,507025,844641,6.305,16.807,1258810,455743,803067,5.667,15.653,92856,1.155,31.305,29793,30604,206401
2004,49,44032,53473,913101,905929,7946,15.135,6002,11.432,164921,64253,100668,7.092,18.205,149508,65094,84414,7.185,16.503,15413,1.701,33.007,3835,3880,23617
2004,50,16911,19560,253061,252938,1853,9.539,1584,8.154,28316,10191,18125,4.029,11.195,28136,8165,19971,3.228,11.124,180,0.071,22.247,1033,1046,4617
2004,51,131598,169659,3043725,2990415,19683,11.773,14727,8.809,481832,158956,322876,5.316,16.113,373876,120736,253140,4.037,12.502,107956,3.610,25.005,9133,9300,54985
2004,53,122818,150276,2256149,2230637,18347,12.343,15085,10.148,334852,109034,225818,4.888,15.011,284853,90715,194138,4.067,12.770,49999,2.241,25.540,9763,9946,49759
2004,54,29555,37389,568781,566032,3545,9.534,3129,8.416,74326,22759,51567,4.021,13.131,69568,23823,45745,4.209,12.290,4758,0.841,24.581,2064,2120,10697
2004,55,103208,129367,2433330,2410103,11787,9.164,10289,8.000,314321,96577,217744,4.007,13.042,267090,86699,180391,3.597,11.082,47231,1.960,22.164,6687,6912,40347
2004,56,14653,16925,188857,185343,1903,11.354,1573,9.385,30863,9560,21303,5.158,16.652,23865,8534,15331,4.604,12.876,6998,3.776,25.752,984,990,4389
2005,01,72505,94174,1677276,1658228,9698,10.361,8546,9.131,263962,82662,181300,4.985,15.918,227143,67482,159661,4.070,13.698,36819,2.220,27.396,5684,5790,32394
2005,02,13573,16568,227658,224051,1911,11.646,1594,9.714,36286,11527,24759,5.145,16.195,29014,7567,21447,3.377,12.950,7272,3.246,25.900,1019,1049,4913
2005,04,89489,114818,2165357,2106859,16344,14.520,11835,10.514,413268,162594,250674,7.717,19.615,296912,101591,195321,4.822,14.093,116356,5.523,28.185,7597,7841,49729
2005,05,47592,59985,1012458,1004082,6428,10.791,5598,9.397,138582,47558,91024,4.736,13.802,122003,38415,83588,3.826,12.151,16579,1.651,24.301,3984,4041,22696
2005,06,606436,753532,13142196,13059882,95357,12.778,80756,10.822,2083861,757804,1326057,5.803,15.956,1915619,636480,1279139,4.874,14.668,168242,1.288,29.336,54385,55702,352641
2005,08,106937,130034,1914669,1905513,17643,13.744,14317,11.153,298761,113395,185366,5.951,15.679,280568,97517,183051,5.118,14.724,18193,0.955,29.448,9248,9398,49961
2005,09,69164,84039,1518116,1526672,8235,9.830,7704,9.196,183440,72831,110609,4.771,12.016,199945,68897,131048,4.513,13.097,-16505,-1.081,24.031,4801,4864,28771
2005,10,18345,22520,395629,393898,2420,10.769,2324,10.342,56494,18957,37537,4.813,14.342,52990,21825,31165,5.541,13.453,3504,0.890,26.905,1349,1367,9259
2005,11,14992,18668,426360,424850,1876,10.099,1692,9.109,53992,18128,35864,4.267,12.709,51512,14397,37115,3.389,12.125,2480,0.584,24.250,921,943,6243
2005,12,355534,437621,6838182,6754453,67902,15.834,50348,11.740,1237831,491931,745900,7.283,18.326,1070563,403325,667238,5.971,15.850,167268,2.476,31.699,33403,33925,220268
2005,13,152026,194637,3478867,3455593,24994,12.995,20405,10.609,546558,203679,342879,5.894,15.817,500885,172343,328542,4.987,14.495,45673,1.322,28.990,13084,13346,80373
2005,15,23553,29464,486395,478840,3004,10.308,2361,8.102,71924,27419,44505,5.726,15.020,56551,18123,38428,3.785,11.810,15373,3.210,23.620,1521,1581,8343
2005,16,31777,37618,513501,499557,5277,14.365,3512,9.560,91536,35950,55586,7.196,18.323,63310,20253,43057,4.054,12.673,28226,5.650,25.346,2296,2330,13171
2005,17,224878,281080,5218572,5209801,30349,10.858,27214,9.736,712352,258004,454348,4.952,13.673,694118,221948,472170,4.260,13.323,18234,0.350,26.647,17119,17534,107250
2005,18,104932,136647,2600861,2591568,13047,9.565,12553,9.203,338441,114974,223467,4.436,13.059,320778,101822,218956,3.929,12.378,17663,0.682,24.756,8127,8373,53996
2005,19,58321,74009,1265303,1254456,6559,8.893,6055,8.209,156021,50795,105226,4.049,12.437,134509,40394,94115,3.220,10.722,21512,1.715,21.445,4056,4141,21458
2005,20,55542,69540,1126840,1123946,6806,9.830,6194,8.946,150850,49578,101272,4.411,13.421,145010,49827,95183,4.433,12.902,5840,0.520,25.804,4106,4195,22946
2005,21,65604,84524,1511050,1498917,8346,9.920,7566,8.993,213439,69300,144139,4.623,14.240,189025,55220,133805,3.684,12.611,24414,1.629,25.222,5075,5182,29739
2005,22,74680,94676,1609831,1614260,9229,9.770,8803,9.319,240611,75187,165424,4.658,14.905,248584,89863,158721,5.567,15.399,-7973,-0.494,29.811,5746,5918,43870
2005,23,30311,36349,498046,496713,3713,10.282,3237,8.964,62096,21169,40927,4.262,12.501,59402,17901,41501,3.604,11.959,2694,0.542,23.918,2130,2148,9960
2005,24,99358,123109,2161633,2153495,13979,11.459,11740,9.624,307377,111381,195996,5.172,14.273,291671,96931,194740,4.501,13.544,15706,0.729,27.088,7325,7444,48392
2005,25,126650,156414,2992042,2985216,15440,9.865,15623,9.982,378170,126815,251355,4.248,12.668,363257,126519,236738,4.238,12.169,14913,0.500,24.337,10416,10577,56662
2005,26,167066,211101,3774851,3817783,21140,10.025,20670,9.802,505813,188832,316981,4.946,13.249,590282,166463,423819,4.360,15.461,-84469,-2.213,26.498,13361,13633,89899
2005,27,104696,130327,2416463,2397455,13615,10.522,11753,9.083,320953,112110,208843,4.676,13.387,282162,86295,195867,3.599,11.769,38791,1.618,23.538,7465,7565,42969
2005,28,43718,55885,925161,928067,5723,10.265,5459,9.791,124233,42614,81619,4.592,13.386,129803,42676,87127,4.598,13.986,-5570,-0.600,26.772,3576,3650,22555
2005,29,110103,138851,2391116,2393158,16017,11.643,13451,9.778,308918,111755,197163,4.670,12.908,313848,88477,225371,3.697,13.114,-4930,-0.206,25.817,9299,9465,51043
2005,30,26494,30743,326775,321028,3651,12.040,2812,9.273,52126,21310,30816,6.638,16.237,40689,11909,28780,3.710,12.675,11437,3.563,25.349,1856,1882,7604
2005,31,37612,46443,769913,763409,4284,9.267,3851,8.331,104073,32503,71570,4.258,13.633,91235,27258,63977,3.571,11.951,12838,1.682,23.902,2500,2556,13581
2005,32,40332,49967,1083010,1053972,7919,16.208,5700,11.667,200758,72122,128636,6.843,19.048,143063,59459,83604,5.641,13.574,57695,5.474,27.147,3857,3938,34918
2005,33,29405,35311,553394,552241,3685,10.507,3204,9.136,70614,26242,44372,4.752,12.787,67969,20671,47298,3.743,12.308,2645,0.479,24.616,2210,2232,13127
2005,34,181234,213923,3578790,3593663,24761,11.634,22596,10.616,505594,182062,323532,5.066,14.069,535875,194217,341658,5.404,14.912,-30281,-0.843,28.138,15054,15241,89272
2005,35,32736,40473,597329,589470,4538,11.318,3782,9.433,98324,33584,64740,5.697,16.680,82522,25223,57299,4.279,13.999,15802,2.681,27.999,2450,2504,15280
2005,36,381550,449296,7340539,7351108,50866,11.360,47814,10.678,998889,362002,636887,4.924,13.588,1019950,339748,680202,4.622,13.875,-21061,-0.287,27.177,31973,32375,179098
2005,37,153350,196305,3405772,3387417,22535,11.593,18704,9.622,505497,186607,318890,5.509,14.923,470423,147084,323339,4.342,13.887,35074,1.035,27.775,12099,12397,71521
2005,38,15536,18822,271241,268886,1726,9.236,1457,7.797,34679,10830,23849,4.028,12.897,30116,10703,19413,3.981,11.200,4563,1.697,22.401,970,981,4655
2005,39,186643,246743,4733863,4731346,22575,9.155,22244,9.021,645198,225050,420148,4.757,13.637,639498,197042,442456,4.165,13.516,5700,0.120,27.032,14146,14486,98280
2005,40,64314,80366,1213377,1200909,8703,10.910,7517,9.423,180862,67750,113112,5.642,15.060,156507,51381,105126,4.279,13.032,24355,2.028,26.065,5088,5189,29919
2005,41,78683,95805,1401331,1375189,11883,12.582,9162,9.701,215670,80127,135543,5.827,15.683,163149,56906,106243,4.138,11.864,52521,3.819,23.728,5913,6068,30114
2005,42,216403,276602,5068040,5063716,26388,9.579,24137,8.762,642798,231103,411695,4.564,12.694,634422,196832,437590,3.887,12.529,8376,0.165,25.058,15418,15787,88925
2005,44,23216,26754,441040,439167,2761,10.364,2533,9.508,53676,20108,33568,4.579,12.222,49911,15252,34659,3.473,11.365,3765,0.857,22.730,1680,1688,9148
2005,45,74021,94423,1595985,1583858,10924,11.706,8722,9.346,233802,85952,147850,5.427,14.762,209485,65362,144123,4.127,13.226,24317,1.535,26.452,5853,5962,34944
2005,46,19105,22587,317490,314600,2214,9.872,1892,8.437,40953,11475,29478,3.647,13.018,35370,11021,24349,3.503,11.243,5583,1.775,22.486,1225,1244,5612
2005,47,92944,123009,2358200,2348646,13150,10.754,11687,9.558,332650,110131,222519,4.689,14.163,313534,95757,217777,4.077,13.350,19116,0.814,26.699,7628,7838,47038
2005,48,342036,452892,8267151,8185935,53861,11.995,46134,10.274,1352274,511691,840583,6.251,16.519,1191352,381703,809649,4.663,14.554,160922,1.966,29.107,30008,30788,199696
2005,49,45949,55634,957887,935796,8360,15.324,6203,11.370,175082,60122,114960,6.425,18.709,130525,49054,81471,5.242,13.948,44557,4.761,27.896,3974,4051,25032
2005,50,17012,19716,258747,256032,1833,9.332,1687,8.588,33615,10618,22997,4.147,13.129,28007,9067,18940,3.541,10.939,5608,2.190,21.878,1110,1122,5578
2005,51,134688,173327,3069573,3054998,19785,11.536,16149,9.416,448345,159075,289270,5.207,14.676,418946,129505,289441,4.239,13.713,29399,0.962,27.427,10070,10359,56192
2005,53,126278,154338,2317336,2287033,19762,12.975,15698,10.307,364861,124358,240503,5.438,15.953,302986,102832,200154,4.496,13.248,61875,2.705,26.496,10059,10276,51113
2005,54,29544,37516,569171,568939,3596,9.602,3466,9.255,75182,24190,50992,4.252,13.214,74606,22137,52469,3.891,13.113,576,0.101,26.226,2305,2332,10959
2005,55,104208,130805,2443243,2435531,12173,9.358,10738,8.254,304994,97582,207412,4.007,12.523,288940,90292,198648,3.707,11.864,16054,0.659,23.727,7102,7297,43676
2005,56,14991,17396,194556,192209,2057,11.986,1589,9.259,31565,10958,20607,5.701,16.422,26777,8076,18701,4.202,13.931,4788,2.491,27.862,1106,1114,5171
2006,01,73340,96154,1715506,1696244,10753,11.299,8775,9.221,270161,103777,166384,6.118,15.927,231566,73043,158523,4.306,13.652,38595,2.275,27.303,5970,6088,35859
2006,02,13801,17031,242008,236449,2175,12.948,1710,10.179,40862,11228,29634,4.749,17.282,29958,9117,20841,3.856,12.670,10904,4.612,25.340,1125,1146,5244
2006,04,94775,122348,2345081,2257692,19572,16.505,12041,10.154,459090,176631,282459,7.824,20.334,283209,98283,184926,4.353,12.544,175881,7.790,25.088,8081,8253,54395
2006,05,47932,61169,1042867,1027642,7117,11.749,5926,9.783,146812,52386,94426,5.098,14.286,116168,35612,80556,3.465,11.304,30644,2.982,22.609,4224,4307,21577
2006,06,624038,778867,13707707,13454231,105791,13.808,80346,10.487,2346579,869051,1477528,6.459,17.441,1838818,609959,1228859,4.534,13.667,507761,3.774,27.334,55835,56899,332601
2006,08,110015,134453,1999451,1957889,19336,14.621,14925,11.286,347341,138526,208815,7.075,17.741,264476,96419,168057,4.925,13.508,82865,4.232,27.016,9831,9974,51813
2006,09,69362,85004,1542909,1531164,8884,10.511,7923,9.374,208625,76576,132049,5.001,13.625,184500,65209,119291,4.259,12.050,24125,1.576,24.099,5413,5517,31342
2006,10,18360,22706,389519,391770,2657,11.746,2485,10.986,55756,20544,35212,5.244,14.232,60182,24004,36178,6.127,15.362,-4426,-1.130,28.464,1662,1698,8828
2006,11,15286,19169,436030,431218,2193,11.593,1688,8.923,62894,20553,42341,4.766,14.585,52863,15642,37221,3.627,12.259,10031,2.326,24.518,948,959,6780
2006,12,370319,456476,7208790,7024619,71546,16.004,52668,11.782,1314222,506574,807648,7.211,18.709,952099,360441,591658,5.131,13.554,362123,5.155,27.107,36443,36977,205302
2006,13,157004,201564,3615297,3549973,27612,13.938,20687,10.443,606037,238139,367898,6.708,17.072,477922,168275,309647,4.740,13.463,128115,3.609,26.925,13676,13932,83148
2006,15,24161,30509,510202,498263,3408,11.365,2364,7.883,76290,28256,48034,5.671,15.311,52276,15578,36698,3.126,10.492,24014,4.820,20.983,1578,1607,8808
2006,16,33886,40102,541460,528020,6317,16.257,3826,9.846,94929,35354,59575,6.696,17.978,68315,25055,43260,4.745,12.938,26614,5.040,25.876,2654,2683,17214
2006,17,227899,286375,5346515,5286749,32802,11.562,27476,9.684,789242,282437,506805,5.342,14.929,671094,233668,437426,4.420,12.694,118148,2.235,25.388,18016,18363,121259
2006,18,105929,139070,2659870,2632632,14897,10.806,12484,9.055,366962,129044,237918,4.902,13.939,312360,94216,218144,3.579,11.865,54602,2.074,23.730,8206,8376,49271
2006,19,58239,75014,1300552,1283255,7733,10.378,6731,9.033,167859,58304,109555,4.543,13.081,133078,37396,95682,2.914,10.370,34781,2.710,20.741,4625,4722,21428
2006,20,55680,70222,1163455,1147695,7529,10.776,6826,9.770,168267,60596,107671,5.280,14.661,136287,44129,92158,3.845,11.875,31980,2.786,23.750,4615,4715,23305
2006,21,65967,85747,1546669,1528548,8928,10.488,7684,9.027,219532,74490,145042,4.873,14.362,183726,58271,125455,3.812,12.020,35806,2.342,24.039,5269,5361,29636
2006,22,72023,92469,1587916,1598822,10449,11.167,12647,13.516,274635,98219,176416,6.143,17.177,298188,100651,197537,6.295,18.650,-23553,-1.473,34.355,7537,7697,46071
2006,23,30659,37043,506089,502396,4241,11.558,3544,9.658,65994,25601,40393,5.096,13.136,58720,19137,39583,3.809,11.688,7274,1.448,23.376,2531,2556,11251
2006,24,101468,126355,2228727,2195336,15238,12.216,12000,9.620,345757,125220,220537,5.704,15.750,279834,97049,182785,4.421,12.747,65923,3.003,25.494,7901,8035,44763
2006,25,128277,159188,3064358,3029589,17083,10.826,14289,9.056,437150,149239,287911,4.926,14.429,369558,120039,249519,3.962,12.198,67592,2.231,24.397,9507,9665,58234
2006,26,167229,212717,3779159,3771571,22487,10.612,20875,9.851,526881,181949,344932,4.824,13.970,512016,160562,351454,4.257,13.576,14865,0.394,27.151,14377,14617,83278
2006,27,106078,133187,2471473,2444513,15512,11.773,12656,9.605,345794,119654,226140,4.895,14.146,291019,94250,196769,3.856,11.905,54775,2.241,23.810,8433,8577,48502
2006,28,43401,55996,945599,936284,6304,11.269,6195,11.074,147866,54769,93097,5.850,15.793,129941,42360,87581,4.524,13.878,17925,1.914,27.757,3986,4058,21398
2006,29,109431,139795,2440248,2415279,16417,11.785,15445,11.087,356138,132404,223734,5.482,14.745,304999,100457,204542,4.159,12.628,51139,2.117,25.256,11048,11255,52437
2006,30,27547,32037,338060,332829,4344,13.839,3049,9.713,55207,21138,34069,6.351,16.587,44585,13978,30607,4.200,13.396,10622,3.191,26.792,2065,2090,8706
2006,31,37789,47100,783666,777011,4874,10.421,4214,9.010,102217,39907,62310,5.136,13.155,88239,26694,61545,3.435,11.356,13978,1.799,22.712,2848,2914,14187
2006,32,42517,53034,1163826,1124399,8926,17.336,5832,11.327,220646,84194,136452,7.488,19.623,143867,44671,99196,3.973,12.795,76779,6.828,25.590,4106,4158,26097
2006,33,29620,35807,573931,564215,3921,11.027,3426,9.635,85295,29153,56142,5.167,15.117,65763,21207,44556,3.759,11.656,19532,3.462,23.311,2409,2444,11305
2006,34,183888,218292,3660515,3621483,26711,12.360,22327,10.332,563785,209766,354019,5.792,15.568,484984,164194,320790,4.534,13.392,78801,2.176,26.784,15731,15878,79085
2006,35,33533,41645,632900,615102,5196,12.654,4030,9.814,112831,41389,71442,6.729,18.343,77140,26961,50179,4.383,12.541,35691,5.802,25.082,2694,2730,14592
2006,36,385289,456100,7486062,7418748,54315,11.998,47517,10.496,1064890,379458,685432,5.115,14.354,929768,308390,621378,4.157,12.533,135122,1.821,25.065,34581,34959,183997
2006,37,157059,202680,3528453,3470127,25367,12.716,18986,9.517,564216,215749,348467,6.217,16.259,447808,154334,293474,4.448,12.905,116408,3.355,25.809,12815,13035,71219
2006,38,15637,19108,280641,276003,1973,10.404,1685,8.885,38971,13356,25615,4.839,14.120,29816,9883,19933,3.581,10.803,9155,3.317,21.606,1133,1146,5239
2006,39,186141,248497,4796675,4764924,24737,9.990,22981,9.281,661225,234567,426658,4.923,13.877,599411,198242,401169,4.160,12.580,61814,1.297,25.159,15106,15476,91783
2006,40,65182,81885,1277551,1245930,9400,11.588,7868,9.699,213050,80955,132095,6.498,17.100,149983,51789,98194,4.157,12.038,63067,5.062,24.076,5280,5430,26903
2006,41,81112,99259,1457677,1430093,12796,13.120,9345,9.581,226971,81173,145798,5.676,15.871,172236,52552,119684,3.675,12.044,54735,3.827,24.087,6471,6526,30476
2006,42,216624,279838,5186254,5128600,27892,10.025,24646,8.859,693645,251070,442575,4.895,13.525,578975,182179,396796,3.552,11.289,114670,2.236,22.578,16571,17019,94157
2006,44,23528,27267,440736,440845,3091,11.445,2571,9.520,61392,23048,38344,5.228,13.926,61653,16930,44723,3.840,13.985,-261,-0.059,27.852,1737,1776,8758
2006,45,75739,97205,1651612,1624517,11777,12.292,8984,9.377,261132,97529,163603,6.004,16.074,207735,65822,141913,4.052,12.787,53397,3.287,25.575,6158,6312,33320
2006,46,19312,22914,330143,323800,2520,11.077,2193,9.639,45623,15027,30596,4.641,14.090,32924,10475,22449,3.235,10.168,12699,3.922,20.336,1523,1551,6823
2006,47,94163,125636,2447632,2404068,14527,11.685,11891,9.565,374965,134182,240783,5.581,15.597,287710,92685,195025,3.855,11.968,87255,3.629,23.935,7796,8011,44514
2006,48,348430,465478,8710930,8495071,59637,12.988,47035,10.243,1543144,569558,973586,6.705,18.165,1115018,396229,718789,4.664,13.125,428126,5.040,26.251,30843,31625,192338
2006,49,48913,59245,1024231,991547,9755,16.983,6145,10.698,185014,65915,119099,6.648,18.659,119917,39649,80268,3.999,12.094,65097,6.565,24.188,4115,4207,23811
2006,50,17106,19916,262489,260757,1988,10.034,1783,8.999,30740,9803,20937,3.759,11.789,27174,8303,18871,3.184,10.421,3566,1.368,20.842,1267,1279,5192
2006,51,138283,179347,3193545,3133244,22450,12.732,16419,9.311,513232,183516,329716,5.857,16.380,392971,124483,268488,3.973,12.542,120261,3.838,25.084,10917,11089,60758
2006,53,130095,159704,2415080,2368233,21582,13.745,16213,10.325,401051,140538,260513,5.934,16.935,309639,95126,214513,4.017,13.075,91412,3.860,26.149,11078,11241,52943
2006,54,29414,37729,589704,580234,3801,10.102,3595,9.555,86981,30731,56250,5.296,14.991,68144,20966,47178,3.613,11.744,18837,3.246,23.488,2465,2505,11995
2006,55,104402,132366,2477117,2464315,13414,10.194,11851,9.006,310607,109046,201561,4.425,12.604,283708,81086,202622,3.290,11.513,26899,1.092,23.025,8150,8287,44168
2006,56,15408,17894,206765,201365,2299,13.030,1798,10.191,36528,12300,24228,6.108,18.140,25799,8590,17209,4.266,12.812,10729,5.328,25.624,1193,1205,5421
2007,01,74187,97869,1717477,1716829,10821,11.157,9064,9.345,257399,92813,164586,5.406,14.993,256285,82331,173954,4.796,14.928,1114,0.065,29.856,5861,6065,36139
2007,02,13839,17182,244710,243280,2030,11.873,1862,10.890,42762,14649,28113,6.021,17.577,39770,9544,30226,3.923,16.347,2992,1.230,32.695,1148,1164,4943
2007,04,97302,126302,2392521,2368720,18277,14.702,14299,11.502,448051,155721,292330,6.574,18.915,401362,129295,272067,5.458,16.944,46689,1.971,33.889,9165,9339,59155
2007,05,48092,61810,1026895,1035029,6687,10.879,6005,9.769,144316,50852,93464,4.913,13.943,160181,48135,112046,4.651,15.476,-15865,-1.533,27.886,4040,4085,23017
2007,06,631940,790026,13689685,13702771,100798,12.851,89425,11.401,2176676,755874,1420802,5.516,15.885,2203701,740912,1462789,5.407,16.082,-27025,-0.197,31.770,58428,59505,365245
2007,08,112049,137449,2038562,2020936,19001,13.978,15965,11.745,357443,133985,223458,6.630,17.687,322501,114265,208236,5.654,15.958,34942,1.729,31.916,10223,10333,54783
2007,09,68878,85079,1523127,1533382,8300,9.761,8203,9.647,208757,75196,133561,4.904,13.614,228255,63556,164699,4.145,14.886,-19498,-1.272,27.228,5206,5285,31581
2007,10,18105,22729,386147,387819,2590,11.398,2577,11.341,65392,28329,37063,7.305,16.861,69072,25712,43360,6.630,17.810,-3680,-0.949,33.723,1505,1510,9669
2007,11,15341,19395,437834,437197,2100,10.893,1868,9.689,69160,20234,48926,4.628,15.819,68349,18972,49377,4.339,15.633,811,0.186,31.267,1010,1018,6928
2007,12,373532,462939,7221689,7229552,67880,14.767,61337,13.344,1235065,492507,742558,6.812,17.084,1258178,467849,790329,6.471,17.403,-23113,-0.320,34.167,41632,42317,252217
2007,13,160348,206716,3632943,3626297,27677,13.559,22490,11.018,580831,229438,351393,6.327,16.017,566281,195810,370471,5.400,15.616,14550,0.401,31.232,14512,14913,91243
2007,15,24301,30691,516070,512734,3079,10.063,2893,9.455,76218,24838,51380,4.844,14.865,69678,25063,44615,4.888,13.590,6540,1.276,27.179,1763,1824,12458
2007,16,35168,41710,545702,543529,5891,14.406,4259,10.415,93846,35412,58434,6.515,17.266,89791,26240,63551,4.828,16.520,4055,0.746,33.040,2927,2952,16883
2007,17,228534,288250,5350607,5349305,31181,10.854,29216,10.170,776460,268989,507471,5.028,14.515,774206,248346,525860,4.643,14.473,2254,0.042,28.946,18238,18523,117572
2007,18,105803,139875,2635618,2647653,14262,10.228,13382,9.597,366879,124834,242045,4.715,13.857,391242,116256,274986,4.391,14.777,-24363,-0.920,27.714,8578,8762,56674
2007,19,58239,75278,1297128,1298889,6774,9.016,6492,8.640,161898,48844,113054,3.760,12.464,165614,50282,115332,3.871,12.750,-3716,-0.286,24.929,4135,4199,23184
2007,20,55755,70674,1180696,1172503,7168,10.176,6696,9.506,170333,61409,108924,5.237,14.527,154113,49427,104686,4.216,13.144,16220,1.383,26.288,4264,4340,24689
2007,21,65882,86239,1541076,1544516,8694,10.114,8133,9.462,219092,76984,142108,4.984,14.185,225983,63790,162193,4.130,14.631,-6891,-0.446,28.370,5264,5343,33179
2007,22,74763,95849,1635340,1612044,11874,12.614,8439,8.965,283636,91914,191722,5.702,17.595,236427,71141,165286,4.413,14.666,47209,2.929,29.333,5241,5322,33642
2007,23,30708,37360,500736,503325,3995,10.741,3662,9.846,66737,23703,43034,4.709,13.259,72073,26639,45434,5.293,14.319,-5336,-1.060,26.518,2445,2462,13789
2007,24,101735,127231,2222880,2226135,14101,11.123,13197,10.409,325869,108122,217747,4.857,14.638,333324,104103,229221,4.676,14.973,-7455,-0.335,29.277,8342,8460,48124
2007,25,127607,159089,3065563,3061384,15587,9.796,15642,9.831,414822,130172,284650,4.252,13.550,405212,125118,280094,4.087,13.236,9610,0.314,26.472,9800,9967,54178
2007,26,164604,210730,3670458,3724007,21097,9.967,22955,10.845,487954,169035,318919,4.539,13.103,593958,189058,404900,5.077,15.949,-106004,-2.847,26.206,14903,15260,98815
2007,27,105835,133179,2510613,2489965,14051,10.553,13994,10.510,368025,114967,253058,4.617,14.780,327574,106597,220977,4.281,13.156,40451,1.625,26.312,8445,8539,46686
2007,28,44125,57148,939115,942070,6474,11.450,5265,9.311,131340,42077,89263,4.466,13.942,136900,40275,96625,4.275,14.532,-5560,-0.590,27.883,3535,3604,19871
2007,29,108815,140088,2429916,2435851,15248,10.900,14854,10.618,334618,117529,217089,4.825,13.737,345239,108239,237000,4.444,14.173,-10621,-0.436,27.474,9876,10074,51985
2007,30,28301,32958,353814,348020,4080,12.561,3126,9.624,58005,19916,38089,5.723,16.667,46141,14598,31543,4.195,13.258,11864,3.409,26.516,2089,2112,8875
2007,31,37829,47408,791477,787462,4562,9.656,4233,8.960,104357,33224,71133,4.219,13.252,97162,29891,67271,3.796,12.339,7195,0.914,24.677,2695,2711,14512
2007,32,43621,54772,1188392,1176591,8628,16.007,6886,12.775,222474,83279,139195,7.078,18.908,198854,67517,131337,5.738,16.901,23620,2.007,33.802,4633,4680,31013
2007,33,29471,35837,573032,573676,3630,10.135,3591,10.026,74900,22722,52178,3.961,13.056,76663,21658,55005,3.775,13.363,-1763,-0.307,26.112,2396,2412,12256
2007,34,183338,218123,3640706,3650716,24652,11.298,24812,11.371,534299,178546,355753,4.891,14.635,555954,189356,366598,5.187,15.229,-21655,-0.593,29.271,16466,16589,84286
2007,35,33941,42384,631831,631675,4867,11.588,4097,9.755,99100,33740,65360,5.341,15.688,97920,30410,67510,4.814,15.502,1180,0.187,31.003,2676,2719,15313
2007,36,386607,458869,7476831,7480332,51902,11.346,49050,10.723,1064269,362656,701613,4.848,14.228,1068417,371316,697101,4.964,14.283,-4148,-0.055,28.455,33455,33763,181319
2007,37,159658,207000,3561199,3546668,24862,12.135,20604,10.057,550397,193725,356672,5.462,15.519,521590,168095,353495,4.740,14.706,28807,0.812,29.413,13008,13284,76973
2007,38,15776,19354,289947,285212,1866,9.710,1592,8.284,44574,15498,29076,5.434,15.628,34897,9594,25303,3.364,12.235,9677,3.393,24.471,973,998,5567
2007,39,183664,247345,4753348,4775883,23506,9.483,24576,9.914,631188,225312,405876,4.718,13.216,676623,220370,456253,4.614,14.167,-45435,-0.951,26.432,14996,15325,96595
2007,40,65752,83161,1300292,1289000,9341,11.323,8015,9.715,214209,69421,144788,5.386,16.618,191064,61290,129774,4.755,14.823,23145,1.796,29.645,5279,5355,31707
2007,41,82635,101405,1470077,1463068,12187,12.148,10018,9.986,215867,71911,143956,4.915,14.754,201307,63748,137559,4.357,13.759,14560,0.995,27.518,6594,6696,33174
2007,42,215984,279778,5179861,5182987,26376,9.429,26293,9.399,685862,229218,456644,4.423,13.233,690551,230448,460103,4.446,13.323,-4689,-0.090,26.466,15683,16012,92401
2007,44,23299,27212,443220,441787,2758,10.125,2814,10.330,62102,22560,39542,5.107,14.057,59724,20436,39288,4.626,13.519,2378,0.538,27.037,1905,1923,11319
2007,45,76696,99159,1662949,1657621,11689,11.908,9699,9.880,254379,89261,165118,5.385,15.346,245125,79548,165577,4.799,14.788,9254,0.558,29.576,6415,6563,40074
2007,46,19441,23212,331590,330222,2396,10.399,2053,8.910,44636,15195,29441,4.601,13.517,42011,12877,29134,3.899,12.722,2625,0.795,25.444,1337,1348,6695
2007,47,94974,127351,2469459,2455837,14056,11.113,12322,9.742,383906,126848,257058,5.165,15.632,358539,116587,241952,4.747,14.599,25367,1.033,29.199,7661,7813,47967
2007,48,353737,475203,8987431,8851896,59808,12.721,49678,10.567,1619356,562411,1056945,6.354,18.294,1347959,483379,864580,5.461,15.228,271397,3.066,30.456,30815,31539,208024
2007,49,51516,62197,1094950,1068639,9689,15.958,6724,11.075,198721,62632,136089,5.861,18.596,146276,52433,93843,4.907,13.688,52445,4.908,27.376,4399,4424,25803
2007,50,17154,19952,261680,262120,1948,9.776,1896,9.515,32139,10289,21850,3.925,12.261,32757,10866,21891,4.145,12.497,-618,-0.236,24.522,1175,1185,4977
2007,51,139557,181971,3190758,3191549,21080,11.670,18408,10.191,494701,173619,321082,5.440,15.500,496509,152663,343846,4.783,15.557,-1808,-0.057,31.001,11407,11566,62977
2007,53,132838,163191,2491408,2452267,20931,12.967,17386,10.771,400251,125564,274687,5.120,16.322,319998,106337,213661,4.336,13.049,80253,3.273,26.098,11257,11369,55887
2007,54,29180,37638,579921,584669,3509,9.314,3579,9.500,80002,26718,53284,4.570,13.683,88932,28260,60672,4.834,15.211,-8930,-1.527,27.367,2313,2354,14937
2007,55,104148,132490,2478714,2478310,12599,9.515,12433,9.390,307964,100987,206977,4.075,12.426,307129,96020,211109,3.874,12.393,835,0.034,24.785,7823,7955,43430
2007,56,15751,18350,215709,211314,2238,12.360,1753,9.681,38033,11761,26272,5.566,17.998,29209,9428,19781,4.462,13.823,8824,4.176,27.645,1161,1185,5278
2008,01,73330,97142,1708691,1713249,9018,9.251,9705,9.955,235276,75996,159280,4.436,13.733,244554,85937,158617,5.016,14.274,-9278,-0.542,27.465,6428,6619,40923
2008,02,13679,17019,247205,245844,1812,10.600,1964,11.489,35509,10161,25348,4.133,14.444,32849,8979,23870,3.652,13.362,2660,1.082,26.723,1197,1210,4995
2008,04,96436,125935,2316420,2355009,15948,12.648,16260,12.895,351503,131907,219596,5.601,14.926,428251,132256,295995,5.616,18.185,-76748,-3.259,29.852,10865,11085,71251
2008,05,47525,61319,1012848,1019749,5761,9.360,6221,10.107,126226,42535,83691,4.171,12.378,139963,40106,99857,3.933,13.725,-13737,-1.347,24.756,4196,4277,22807
2008,06,625520,784638,13534497,13584179,88006,11.181,92958,11.810,2000822,659885,1340937,4.858,14.729,2107809,696744,1411065,5.129,15.517,-106987,-0.788,29.458,62229,63394,382257
2008,08,111758,137573,2060278,2049300,16828,12.242,16614,12.086,327191,112902,214289,5.509,15.966,306107,109862,196245,5.361,14.937,21084,1.029,29.874,10856,11009,58153
2008,09,68063,84544,1532613,1528808,7556,8.910,8068,9.514,217056,68994,148062,4.513,14.198,210805,61357,149448,4.013,13.789,6251,0.409,27.578,5222,5291,27396
2008,10,17825,22464,384062,384844,2285,10.118,2526,11.185,57544,19279,38265,5.010,14.953,58757,17260,41497,4.485,15.268,-1213,-0.315,29.905,1577,1590,7368
2008,11,15335,19429,443600,440566,1984,10.223,1942,10.006,60581,19248,41333,4.369,13.751,54530,17820,36710,4.045,12.377,6051,1.373,24.755,952,978,5158
2008,12,361574,451437,7076565,7155934,56598,12.382,67945,14.864,1073823,405549,668274,5.667,15.006,1235311,435789,799522,6.090,17.263,-161488,-2.257,30.012,47002,47544,237767
2008,13,158301,205300,3619875,3626877,24030,11.666,25383,12.323,555414,204266,351148,5.632,15.314,570634,203450,367184,5.610,15.733,-15220,-0.420,30.628,16871,17124,98897
2008,15,23987,30451,517158,516943,2678,8.762,2904,9.501,67141,21736,45405,4.205,12.988,67092,20011,47081,3.871,12.979,49,0.009,25.957,1877,1930,11159
2008,16,34549,41279,536064,540771,4777,11.515,5189,12.508,73907,26963,46944,4.986,13.667,83923,25050,58873,4.632,15.519,-10016,-1.852,27.334,3630,3677,16075
2008,17,226207,286837,5387468,5367433,28521,9.921,29811,10.370,741617,222256,519361,4.141,13.817,704270,226238,478032,4.215,13.121,37347,0.696,26.242,19265,19556,109692
2008,18,104289,138305,2596339,2615783,12339,8.873,13864,9.969,326911,100533,226378,3.843,12.498,366770,122581,244189,4.686,14.021,-39859,-1.524,24.995,8924,9149,60341
2008,19,57569,74675,1308279,1301984,6071,8.099,6641,8.859,160636,42974,117662,3.301,12.338,148166,44774,103392,3.439,11.380,12470,0.958,22.760,4259,4344,23012
2008,20,55154,70136,1193168,1186480,6166,8.760,6675,9.483,157363,44006,113357,3.709,13.263,144039,43803,100236,3.692,12.140,13324,1.123,24.280,4317,4422,24011
2008,21,64833,85494,1538287,1539351,7539,8.779,8295,9.660,203467,64333,139134,4.179,13.218,206209,66543,139666,4.323,13.396,-2742,-0.178,26.435,5514,5617,35774
2008,22,74804,96241,1636388,1634777,9329,9.715,8895,9.263,237868,72626,165242,4.443,14.550,234688,68846,165842,4.211,14.356,3180,0.195,28.712,5785,5876,34288
2008,23,30106,36790,505737,503434,3439,9.278,3995,10.777,65547,20679,44868,4.108,13.020,61211,20866,40345,4.145,12.159,4336,0.861,24.317,2619,2667,12233
2008,24,99994,125613,2215627,2217588,12204,9.655,13769,10.894,306241,94311,211930,4.253,13.810,309302,104853,204449,4.728,13.948,-3061,-0.138,27.619,8806,8959,45001
2008,25,125570,157456,3067110,3064392,13846,8.750,15429,9.750,396912,119884,277028,3.912,12.952,392205,124194,268011,4.053,12.799,4707,0.154,25.598,9942,10095,58021
2008,26,160630,206702,3612450,3638896,18864,9.040,22812,10.932,496342,167634,328708,4.607,13.640,550167,188422,361745,5.178,15.119,-53825,-1.479,27.280,15061,15346,105212
2008,27,103972,131499,2484668,2499101,12344,9.330,13968,10.557,314271,102548,211723,4.103,12.575,344354,102546,241808,4.103,13.779,-30083,-1.204,25.151,8934,9144,52458
2008,28,43650,56899,942943,940266,5325,9.340,5551,9.737,131655,41863,89792,4.452,14.002,126521,42116,84405,4.479,13.456,5134,0.546,26.912,3802,3892,20883
2008,29,107064,138763,2440907,2434702,13387,9.604,14627,10.494,330937,112074,218863,4.603,13.593,318501,101303,217198,4.161,13.082,12436,0.511,26.163,9798,9931,47759
2008,30,28140,32874,358666,356234,3415,10.377,3488,10.598,51976,16297,35679,4.575,14.590,47021,15785,31236,4.431,13.199,4955,1.391,26.399,2387,2418,9873
2008,31,37624,47355,793620,793369,4207,8.881,4239,8.949,100706,28410,72296,3.581,12.693,100892,27762,73130,3.499,12.717,-186,-0.023,25.387,2756,2784,13995
2008,32,43254,54754,1154519,1170904,7629,13.938,7592,13.870,179888,70974,108914,6.061,15.363,212382,62728,149654,5.357,18.138,-32494,-2.775,30.726,5318,5426,34033
2008,33,28970,35404,589844,581028,3219,9.038,3640,10.221,93303,27080,66223,4.661,16.058,76804,23493,53311,4.043,13.219,16499,2.840,26.437,2449,2485,11519
2008,34,180027,215092,3588107,3611693,21605,9.976,24563,11.342,499947,169929,330018,4.705,13.842,547598,190112,357486,5.264,15.162,-47651,-1.319,27.685,16907,17096,94848
2008,35,33705,42178,638619,639064,4356,10.306,4535,10.729,96981,35107,61874,5.494,15.175,97870,33392,64478,5.225,15.315,-889,-0.139,30.351,2891,2953,16813
2008,36,386786,459983,7538550,7504309,48698,10.601,47468,10.333,1034144,340307,693837,4.535,13.781,965794,321442,644352,4.283,12.870,68350,0.911,25.740,32914,33254,178673
2008,37,158706,206982,3549931,3552328,21584,10.431,21482,10.381,501326,170219,331107,4.792,14.113,507073,165599,341474,4.662,14.274,-5747,-0.162,28.225,14298,14558,81447
2008,38,15842,19452,305142,297403,1680,8.662,1568,8.084,49144,20961,28183,7.048,16.524,33081,9406,23675,3.163,11.123,16063,5.401,22.247,1003,1019,6590
2008,39,179410,242574,4702758,4727658,19907,8.129,24555,10.027,602646,199630,403016,4.223,12.747,652466,225188,427278,4.763,13.801,-49820,-1.054,25.494,15216,15571,108045
2008,40,65924,83872,1325133,1313611,8645,10.354,7896,9.457,199230,67515,131715,5.140,15.167,176655,55292,121363,4.209,13.448,22575,1.719,26.896,5328,5458,28804
2008,41,82098,101114,1470090,1470949,10722,10.590,10978,10.843,199391,62454,136937,4.246,13.555,201228,62415,138813,4.243,13.680,-1837,-0.125,27.111,7382,7495,35168
2008,42,214002,278894,5204397,5191022,24082,8.622,24884,8.910,662903,199529,463374,3.844,12.770,639737,202733,437004,3.905,12.324,23166,0.446,24.648,15770,16094,89155
2008,44,22799,26683,432020,437373,2432,9.027,2948,10.942,50538,16250,34288,3.715,11.555,61628,18503,43125,4.230,14.091,-11090,-2.536,23.110,1925,1945,9253
2008,45,75833,98747,1663422,1662862,9837,9.942,10223,10.333,233598,73139,160459,4.398,14.048,231165,72877,158288,4.383,13.902,2433,0.146,27.803,6889,6999,37819
2008,46,19341,23222,338629,334978,2157,9.295,2125,9.157,46526,14173,32353,4.231,13.889,39204,14510,24694,4.332,11.703,7322,2.186,23.407,1459,1473,7120
2008,47,94253,127768,2485448,2479256,12964,10.164,12524,9.819,359894,122955,236939,4.959,14.516,347417,94508,252909,3.812,14.013,12477,0.503,28.026,8340,8446,47460
2008,48,356176,479690,9151187,9062963,54112,11.336,49391,10.347,1508574,522756,985818,5.768,16.645,1334403,422904,911499,4.666,14.724,174171,1.922,29.447,31629,32573,210841
2008,49,51613,62600,1105978,1099900,8281,13.273,7859,12.597,183873,58327,125546,5.303,16.717,171689,60406,111283,5.492,15.610,12184,1.108,31.219,5366,5423,29815
2008,50,16880,19683,262014,261651,1698,8.573,1944,9.815,31347,11225,20122,4.290,11.980,30998,10662,20336,4.075,11.847,349,0.133,23.694,1244,1253,6319
2008,51,138256,180463,3175365,3181770,18175,10.032,19586,10.811,447374,136409,310965,4.287,14.061,461157,155628,305529,4.891,14.494,-13783,-0.433,28.121,12321,12528,62975
2008,53,132818,163652,2510963,2500894,18596,11.382,18052,11.049,358244,111352,246892,4.452,14.325,338663,109172,229491,4.365,13.542,19581,0.783,27.083,12133,12351,63212
2008,54,28500,37124,585173,583051,2991,8.003,3494,9.348,77484,21836,55648,3.745,13.289,73356,21441,51915,3.677,12.581,4128,0.708,25.163,2365,2381,11351
2008,55,102441,131167,2480938,2479684,10907,8.276,12168,9.232,287680,85628,202052,3.453,11.601,284897,88991,195906,3.589,11.489,2783,0.112,22.978,8035,8199,46618
2008,56,15825,18458,220788,217511,2035,11.062,1910,10.383,38740,12136,26604,5.579,17.811,32422,10603,21819,4.875,14.906,6318,2.905,29.812,1222,1236,5768
2009,01,71156,94832,1608780,1661149,7679,7.991,10218,10.633,172022,64318,107704,3.872,10.356,277286,72270,205016,4.351,16.692,-105264,-6.337,20.711,6874,7066,37652
2009,02,13563,17004,251513,249505,1806,10.600,1873,10.993,39366,12204,27162,4.891,15.778,35504,10988,24516,4.404,14.230,3862,1.548,28.460,1079,1115,4983
2009,04,91525,120912,2123593,2221342,13166,10.648,18640,15.075,278958,117448,161510,5.287,12.558,474789,162190,312599,7.301,21.374,-195831,-8.816,25.116,12228,12453,99326
2009,05,46680,60559,969382,992171,5428,8.891,6412,10.503,112146,45003,67143,4.536,11.303,158124,47514,110610,4.789,15.937,-45978,-4.634,22.606,4342,4436,27108
2009,06,608810,767112,12719404,13161595,78550,10.106,98783,12.710,1548552,582528,966024,4.426,11.766,2434318,720119,1714199,5.471,18.496,-885766,-6.730,23.531,64940,66381,404885
2009,08,108704,134474,1955369,2010243,14698,10.785,18313,13.438,249981,101926,148055,5.070,12.435,360942,109891,251051,5.467,17.955,-110961,-5.520,24.871,11607,11820,60218
2009,09,66193,82532,1456202,1496026,6373,7.618,8634,10.320,150048,50193,99855,3.355,10.030,228824,62999,165825,4.211,15.295,-78776,-5.266,20.060,5353,5435,32882
2009,10,17341,21970,368403,377024,1985,8.919,2557,11.489,44982,20689,24293,5.487,11.931,62500,17157,45343,4.551,16.577,-17518,-4.646,23.862,1546,1582,8030
2009,11,15280,19611,450880,447967,2057,10.521,1939,9.917,62031,20465,41566,4.568,13.847,56745,15001,41744,3.349,12.667,5286,1.180,25.334,1020,1034,6328
2009,12,347180,437029,6616702,6855537,52606,11.814,69093,15.517,875384,372579,502805,5.435,12.769,1351793,403477,948316,5.885,19.718,-476409,-6.949,25.538,45259,46054,221636
2009,13,151824,198753,3403000,3517570,20638,10.198,27881,13.777,435541,186431,249110,5.300,12.382,665475,206221,459254,5.863,18.919,-229934,-6.537,24.764,18237,18661,112234
2009,15,23560,30087,486615,502314,2565,8.461,3023,9.972,49971,19836,30135,3.949,9.948,81910,22000,59910,4.380,16.307,-31939,-6.358,19.896,1962,2015,13049
2009,16,32658,39427,497982,517446,3757,9.294,5747,14.218,56073,21934,34139,4.239,10.836,94528,28152,66376,5.441,18.268,-38455,-7.432,21.673,3756,3800,17580
2009,17,220842,280897,5063086,5231753,24976,8.784,31835,11.197,533789,193353,340436,3.696,10.203,869650,237225,632425,4.534,16.623,-335861,-6.420,20.406,19966,20338,124162
2009,18,101349,135135,2435693,2517085,10521,7.685,14062,10.271,262601,88432,174169,3.513,10.433,425898,113048,312850,4.491,16.920,-163297,-6.488,20.865,8991,9254,57932
2009,19,56781,73972,1277726,1292899,5409,7.267,6339,8.516,139940,44044,95896,3.407,10.824,169979,39915,130064,3.087,13.147,-30039,-2.323,21.647,4213,4274,24663
2009,20,54236,69257,1158749,1177080,5492,7.868,6581,9.428,126552,40403,86149,3.432,10.751,163506,40814,122692,3.467,13.891,-36954,-3.139,21.503,4318,4445,23348
2009,21,63417,84218,1468929,1506461,6830,8.035,8393,9.874,166907,61438,105469,4.078,11.079,241692,63860,177832,4.239,16.044,-74785,-4.964,22.159,5461,5616,34316
2009,22,74494,96209,1629178,1637408,8527,8.842,8987,9.319,214189,72582,141607,4.433,13.081,229685,68354,161331,4.175,14.027,-15496,-0.946,26.162,5955,6058,39869
2009,23,28976,35715,487231,496759,2921,8.046,4102,11.299,51278,18011,33267,3.626,10.323,70434,19533,50901,3.932,14.179,-19156,-3.856,20.645,2595,2618,12403
2009,24,96977,122988,2116303,2169548,11186,8.982,14281,11.467,253435,96236,157199,4.436,11.681,358896,117732,241164,5.427,16.542,-105461,-4.861,23.363,8837,8977,48956
2009,25,122420,154279,2967689,3019714,12414,7.953,16044,10.278,321198,109908,211290,3.640,10.637,426834,117547,309287,3.893,14.135,-105636,-3.498,21.273,9804,10030,63443
2009,26,155066,200003,3365418,3494550,16424,8.063,23821,11.694,389660,138682,250978,3.969,11.151,648622,177613,471009,5.083,18.561,-258962,-7.410,22.301,14797,15060,95553
2009,27,101410,129082,2378341,2434497,11024,8.447,13890,10.642,266758,90300,176458,3.709,10.957,379402,85316,294086,3.504,15.584,-112644,-4.627,21.915,8597,8784,48305
2009,28,42705,56061,903148,925879,4681,8.270,5758,10.173,105054,44010,61044,4.753,11.346,150721,44325,106396,4.787,16.279,-45667,-4.932,22.693,3907,4039,27546
2009,29,104397,136063,2332353,2386289,12055,8.759,15198,11.042,262034,91903,170131,3.851,10.981,369813,113861,255952,4.771,15.497,-107779,-4.517,21.962,10091,10286,59859
2009,30,27148,31842,339986,349509,2846,8.778,4004,12.350,38457,11941,26516,3.417,11.003,57654,15459,42195,4.423,16.496,-19197,-5.493,22.006,2534,2574,9687
2009,31,37347,47118,778246,786515,3723,7.870,4094,8.655,87153,29794,57359,3.788,11.081,103636,31190,72446,3.966,13.177,-16483,-2.096,22.162,2631,2686,16206
2009,32,41687,53280,1044507,1101772,6636,12.261,8321,15.374,136752,56218,80534,5.103,12.412,252425,63955,188470,5.805,22.911,-115673,-10.499,24.824,5633,5783,37550
2009,33,28027,34451,565834,579094,2789,7.973,3848,11.000,57889,17765,40124,3.068,9.996,84721,20857,63864,3.602,14.630,-26832,-4.633,19.993,2460,2504,12779
2009,34,173544,208774,3416009,3507605,19229,9.056,26333,12.402,393821,142337,251484,4.058,11.228,577462,162580,414882,4.635,16.463,-183641,-5.236,22.455,17499,17764,92447
2009,35,32844,41411,612677,626395,3690,8.811,4624,11.042,73640,26114,47526,4.169,11.756,101197,26593,74604,4.245,16.155,-27557,-4.399,23.512,3052,3093,15739
2009,36,383246,456971,7287895,7420597,45954,10.005,50644,11.026,827328,296884,530444,4.001,11.149,1093141,317375,775766,4.277,14.731,-265813,-3.582,22.298,34212,34606,186604
2009,37,152595,201314,3329998,3444029,18207,8.902,24620,12.038,369858,146277,223581,4.247,10.739,598479,169397,429082,4.919,17.377,-228621,-6.638,21.478,16089,16405,88874
2009,38,15846,19460,292671,294880,1539,7.901,1576,8.091,32914,9364,23550,3.176,11.162,37256,9811,27445,3.327,12.634,-4342,-1.472,22.324,1002,1014,5521
2009,39,173901,236785,4458072,4585647,17797,7.413,24381,10.155,482570,182333,300237,3.976,10.523,738332,202692,535640,4.420,16.101,-255762,-5.577,21.047,15079,15555,103111
2009,40,65657,83699,1284532,1305808,7533,8.973,8044,9.581,158561,54510,104051,4.174,12.143,201093,64455,136638,4.936,15.400,-42532,-3.257,24.286,5451,5553,37499
2009,41,78654,97746,1356402,1412046,8893,8.930,12580,12.632,154075,57349,96726,4.061,10.911,264531,70796,193735,5.014,18.734,-110456,-7.822,21.823,8250,8373,41290
2009,42,210997,276052,5025731,5118590,21689,7.804,25434,9.151,527232,180744,346488,3.531,10.300,713928,209628,504300,4.095,13.948,-186696,-3.647,20.601,15609,16017,110018
2009,44,21812,25631,410382,420888,2048,7.819,3172,12.110,42930,13105,29825,3.114,10.200,63890,18599,45291,4.419,15.180,-20960,-4.980,20.400,2007,2035,10609
2009,45,73040,95989,1545544,1602748,8727,8.951,11734,12.036,172709,71256,101453,4.446,10.776,287574,79868,207706,4.983,17.943,-114865,-7.167,21.552,7693,7975,44309
2009,46,19220,23120,332017,335356,1935,8.336,2122,9.141,37375,11784,25591,3.514,11.145,44127,11994,32133,3.576,13.158,-6752,-2.013,22.290,1407,1417,7854
2009,47,91606,125142,2325046,2408530,10817,8.543,13770,10.875,258990,92169,166821,3.827,10.753,426032,109157,316875,4.532,17.688,-167042,-6.935,21.506,8859,9104,56579
2009,48,354579,480071,8885217,9034080,49722,10.343,51005,10.610,1205107,454994,750113,5.036,13.340,1506852,429022,1077830,4.749,16.680,-301745,-3.340,26.679,32834,33746,216570
2009,49,49447,60630,1051285,1078836,7011,11.355,9243,14.969,140519,50084,90435,4.642,13.025,196318,58618,137700,5.433,18.197,-55799,-5.172,26.050,6186,6256,37312
2009,50,16381,19263,255351,259069,1536,7.873,2031,10.410,28146,11284,16862,4.356,10.864,35921,10688,25233,4.126,13.865,-7775,-3.001,21.729,1253,1270,6232
2009,51,134756,178160,3055986,3119210,16973,9.449,19905,11.081,372089,148309,223780,4.755,11.929,500054,143824,356230,4.611,16.031,-127965,-4.102,23.858,12782,13011,72645
2009,53,127595,158939,2373454,2444906,15373,9.513,20687,12.802,302196,97930,204266,4.005,12.360,443723,116198,327525,4.753,18.149,-141527,-5.789,24.720,13612,13832,68649
2009,54,27879,36741,576183,581870,2782,7.519,3296,8.909,67313,22061,45252,3.791,11.568,79004,20831,58173,3.580,13.578,-11691,-2.009,23.137,2227,2263,12439
2009,55,99911,128773,2350942,2418571,9749,7.490,12531,9.627,214674,70518,144156,2.916,8.876,349226,98959,250267,4.092,14.439,-134552,-5.563,17.752,8094,8251,54472
2009,56,15701,18357,212159,216091,1775,9.625,1944,10.541,28217,8511,19706,3.939,13.058,36078,9846,26232,4.556,16.696,-7861,-3.638,26.116,1320,1344,6395
2010,01,69381,93020,1569737,1588570,7476,7.964,9180,9.779,177889,61286,116603,3.858,11.198,215130,60221,154909,3.791,13.542,-37241,-2.344,22.396,6037,6175,31304
2010,02,13603,17141,253661,252801,1746,10.226,1613,9.447,33302,8728,24574,3.453,13.173,31555,7942,23613,3.142,12.482,1747,0.691,24.964,947,965,3867
2010,04,88673,117963,2060547,2093483,13142,11.002,16117,13.493,288252,114262,173990,5.458,13.769,353779,110179,243600,5.263,16.899,-65527,-3.130,27.538,10030,10311,53023
2010,05,46201,60247,963442,967143,5223,8.645,5565,9.211,115872,40416,75456,4.179,11.981,122750,36708,86042,3.796,12.692,-6878,-0.711,23.962,3677,3785,21643
2010,06,597479,755533,12335868,12529148,77527,10.180,89534,11.757,1542223,552628,989595,4.411,12.309,1927036,606200,1320836,4.838,15.380,-384813,-3.071,24.618,56522,57872,313732
2010,08,106694,132463,1912957,1935228,14892,11.156,16943,12.692,261861,98758,163103,5.103,13.531,305643,96394,209249,4.981,15.794,-43782,-2.262,27.063,10338,10529,49303
2010,09,65027,81317,1426348,1441524,6618,8.077,7852,9.583,154724,51913,102811,3.601,10.733,184079,51164,132915,3.549,12.770,-29355,-2.036,21.467,4753,4855,26030
2010,10,17124,21642,358282,363504,1970,9.031,2314,10.608,39352,12386,26966,3.407,10.826,49392,15191,34201,4.179,13.588,-10040,-2.762,21.651,1332,1356,6034
2010,11,15355,19830,460763,461228,2033,10.307,1822,9.237,56452,19693,36759,4.270,12.239,57200,14975,42225,3.247,12.402,-748,-0.162,24.479,973,986,6082
2010,12,344347,433396,6512011,6567122,54495,12.520,58247,13.382,960723,354711,606012,5.401,14.629,1069123,367859,701264,5.602,16.280,-108400,-1.651,29.259,37188,37859,181422
2010,13,148601,194943,3314722,3357257,19857,10.086,23735,12.055,402512,142896,259616,4.256,11.989,487460,157978,329482,4.706,14.520,-84948,-2.530,23.979,14888,15208,77860
2010,15,23126,29627,477635,482079,2394,8.017,2863,9.588,56389,21104,35285,4.378,11.697,65410,19056,46354,3.953,13.568,-9021,-1.871,23.394,1747,1794,9253
2010,16,31944,38695,487818,492898,3985,10.201,4725,12.095,61711,20696,41015,4.199,12.520,71884,20074,51810,4.073,14.584,-10173,-2.064,25.040,3059,3124,12751
2010,17,217948,277930,4937791,5010284,25575,9.152,28629,10.245,540300,193270,347030,3.857,10.784,687243,197735,489508,3.947,13.717,-146943,-2.933,21.568,17233,17555,101255
2010,18,99583,133354,2396618,2416239,10269,7.649,12079,8.997,272972,86598,186374,3.584,11.297,312418,87554,224864,3.624,12.930,-39446,-1.633,22.595,7612,7802,44732
2010,19,56362,73751,1247646,1262721,5474,7.411,5703,7.721,122688,37816,84872,2.995,9.716,152075,42241,109834,3.345,12.043,-29387,-2.327,19.432,3555,3630,24320
2010,20,53525,68652,1127080,1143599,5433,7.878,6058,8.784,120282,39447,80835,3.449,10.518,153143,42368,110775,3.705,13.391,-32861,-2.873,21.036,3855,3935,21079
2010,21,62508,83467,1441338,1455275,6736,8.033,7501,8.946,165853,57100,108753,3.924,11.397,192991,50546,142445,3.473,13.261,-27138,-1.865,22.793,4809,4953,28537
2010,22,74003,96034,1590890,1610678,8211,8.541,8423,8.761,185544,67708,117836,4.204,11.520,226019,57044,168975,3.542,14.033,-40475,-2.513,23.039,5438,5585,34725
2010,23,28768,35550,479526,483697,3184,8.934,3364,9.439,50855,18356,32499,3.795,10.514,59311,17257,42054,3.568,12.262,-8456,-1.748,21.028,2040,2075,8891
2010,24,95632,121517,2065491,2090630,11306,9.246,12819,10.484,243562,81380,162182,3.893,11.650,293583,85670,207913,4.098,14.043,-50021,-2.393,23.300,7629,7917,43848
2010,25,120908,153130,2932251,2950464,13355,8.687,14549,9.464,323815,104420,219395,3.539,10.975,358785,98939,259846,3.353,12.160,-34970,-1.185,21.950,8695,8905,47249
2010,26,151538,195886,3277771,3322663,16127,8.147,20278,10.243,393200,121971,271229,3.671,11.834,483897,149332,334565,4.494,14.564,-90697,-2.730,23.668,12621,12922,76793
2010,27,100253,128064,2350273,2364275,11074,8.613,12092,9.405,262392,83664,178728,3.539,11.098,289667,86654,203013,3.665,12.252,-27275,-1.154,22.196,7221,7359,40371
2010,28,42147,55552,881665,892318,4519,8.097,5040,9.030,95894,32499,63395,3.642,10.747,117137,33603,83534,3.766,13.127,-21243,-2.381,21.493,3314,3401,19569
2010,29,103490,135139,2276795,2305046,13070,9.639,13983,10.312,256248,91859,164389,3.985,11.117,312887,83114,229773,3.606,13.574,-56639,-2.457,22.234,8815,9054,43291
2010,30,26798,31506,337268,338624,2958,9.338,3299,10.415,43438,16853,26585,4.977,12.828,46275,14144,32131,4.177,13.666,-2837,-0.838,25.656,2066,2093,9456
2010,31,37311,47216,769338,774523,3759,7.968,3674,7.788,79807,23856,55951,3.080,10.304,89780,21203,68577,2.738,11.592,-9973,-1.288,20.608,2234,2295,11898
2010,32,40652,52331,999472,1023192,6562,12.424,7533,14.263,138995,60320,78675,5.895,13.584,185798,53883,131915,5.266,18.159,-46803,-4.574,27.169,4924,5024,32300
2010,33,27747,34148,562307,564044,2946,8.588,3261,9.506,66936,19748,47188,3.501,11.867,70586,19320,51266,3.425,12.514,-3650,-0.647,23.734,2013,2061,10626
2010,34,170231,204921,3353856,3387232,19537,9.443,23475,11.347,395988,139401,256587,4.115,11.691,463057,158423,304634,4.677,13.671,-67069,-1.980,23.381,14743,14934,79903
2010,35,31970,40506,596408,604543,3506,8.560,4413,10.774,68495,22174,46321,3.668,11.330,84853,23606,61247,3.905,14.036,-16358,-2.706,22.660,2822,2870,13578
2010,36,384077,458074,7222140,7257300,48054,10.501,47135,10.300,862690,313576,549114,4.321,11.887,933020,299327,633693,4.124,12.856,-70330,-0.969,23.774,31540,31985,160411
2010,37,150216,199017,3220219,3271998,19376,9.679,21723,10.851,383430,146731,236699,4.484,11.719,485143,150348,334795,4.595,14.827,-101713,-3.109,23.437,13248,13608,70539
2010,38,16046,19714,295225,293899,1625,8.297,1370,6.995,34713,10256,24457,3.490,11.811,31962,8207,23755,2.792,10.875,2751,0.936,21.750,834,845,3566
2010,39,170202,232788,4346139,4402284,17487,7.448,21517,9.164,462163,146041,316122,3.317,10.498,573657,154166,419491,3.502,13.031,-111494,-2.533,20.997,12558,13021,77337
2010,40,64910,83013,1236589,1260267,7027,8.430,7721,9.262,139007,53859,85148,4.274,11.030,186148,53981,132167,4.283,14.771,-47141,-3.741,22.060,5002,5071,27159
2010,41,77433,96807,1319518,1332932,9616,9.885,10564,10.859,155467,55887,99580,4.193,11.664,181485,52816,128669,3.962,13.615,-26018,-1.952,23.327,6609,6746,28556
2010,42,208070,273451,4957729,4992747,21215,7.721,23888,8.693,540978,180352,360626,3.612,10.835,611646,173840,437806,3.482,12.251,-70668,-1.415,21.671,14325,14699,79101
2010,44,21412,25322,397453,404747,2281,8.952,2596,10.189,42567,16608,25959,4.103,10.517,57023,15469,41554,3.822,14.089,-14456,-3.572,21.034,1647,1652,7561
2010,45,71503,94529,1505672,1529158,8594,9.021,10077,10.577,177631,68987,108644,4.511,11.616,224126,62763,161363,4.104,14.657,-46495,-3.041,23.233,6449,6628,34065
2010,46,19228,23234,330529,331307,1978,8.534,1866,8.051,37239,13658,23581,4.122,11.240,38896,10303,28593,3.110,11.740,-1657,-0.500,22.480,1203,1212,5801
2010,47,89900,123383,2274623,2299967,10485,8.438,12248,9.856,268525,88972,179553,3.868,11.675,318278,93795,224483,4.078,13.838,-49753,-2.163,23.350,7671,7900,47724
2010,48,354302,481469,8768612,8829077,49131,10.218,47837,9.949,1199389,470509,728880,5.329,13.585,1314957,375434,939523,4.252,14.893,-115568,-1.309,27.169,30058,30850,185838
2010,49,48774,59941,1010012,1030395,7297,12.102,8007,13.279,128667,50736,77931,4.924,12.487,168478,49846,118632,4.838,16.351,-39811,-3.864,24.974,5068,5203,28606
2010,50,16215,19101,254499,255038,1504,7.838,1677,8.740,26414,9315,17099,3.652,10.357,27511,7133,20378,2.797,10.787,-1097,-0.430,20.714,1037,1045,4366
2010,51,133048,176394,3005321,3032442,16394,9.246,18208,10.270,369003,125995,243008,4.155,12.169,422727,140347,282380,4.628,13.940,-53724,-1.772,24.337,10823,11166,63137
2010,53,125899,157296,2286983,2316774,16040,10.143,17719,11.205,277165,104460,172705,4.509,11.963,336512,94582,241930,4.082,14.525,-59347,-2.562,23.927,11297,11532,49819
2010,54,27232,36201,564477,570444,2501,6.857,3049,8.359,64255,20991,43264,3.680,11.264,75914,19345,56569,3.391,13.308,-11659,-2.044,22.528,1934,2002,9761
2010,55,98315,127326,2318809,2335028,9518,7.432,10988,8.580,232898,77808,155090,3.332,9.974,265490,71461,194029,3.060,11.370,-32592,-1.396,19.948,6873,7062,35228
2010,56,15298,17978,202298,206782,1538,8.465,1920,10.567,24325,7834,16491,3.789,11.764,33141,8082,25059,3.908,16.027,-8816,-4.263,23.527,1227,1245,4948
2011,01,68329,91890,1589338,1579317,7570,8.188,8693,9.403,210931,54987,155944,3.482,13.356,188230,57171,131059,3.620,11.918,22701,1.437,23.837,5479,5764,27775
2011,02,13619,17335,254198,253877,1780,10.326,1585,9.195,31712,10007,21705,3.942,12.491,30850,7737,23113,3.048,12.152,862,0.340,24.303,956,979,3346
2011,04,87773,117224,2117384,2088433,13521,11.498,14254,12.122,323104,107782,215322,5.161,15.471,266094,95785,170309,4.586,12.741,57010,2.730,25.483,9005,9263,49154
2011,05,45765,59945,977301,970341,5282,8.790,5571,9.271,123603,39806,83797,4.102,12.738,110261,31683,78578,3.265,11.363,13342,1.375,22.726,3660,3820,18525
2011,06,598168,758091,12536498,12438031,82625,10.917,80115,10.586,1734287,545731,1188556,4.388,13.943,1541766,542185,999581,4.359,12.396,192521,1.548,24.791,51200,52548,275165
2011,08,106385,132506,1934000,1924339,15277,11.531,15235,11.499,275649,89944,185705,4.674,14.324,255980,84690,171290,4.401,13.302,19669,1.022,26.604,9436,9587,44753
2011,09,64168,80495,1430384,1428480,6536,8.078,7374,9.113,160552,49352,111200,3.455,11.239,156164,49859,106305,3.490,10.932,4388,0.307,21.864,4563,4636,22971
2011,10,16984,21495,357331,358185,1983,9.192,2137,9.906,42620,12158,30462,3.394,11.899,44380,13643,30737,3.809,12.390,-1760,-0.491,23.798,1277,1300,5531
2011,11,15511,20020,471164,465711,1950,9.786,1762,8.843,59770,17118,42652,3.676,12.834,48494,12668,35826,2.720,10.413,11276,2.421,20.826,883,891,5734
2011,12,347020,436960,6643378,6584491,57670,13.252,54114,12.435,1054700,379234,675466,5.760,16.018,935990,351956,584034,5.345,14.215,118710,1.803,28.430,35116,35873,174424
2011,13,147369,194064,3327956,3321646,20640,10.612,21522,11.065,446614,150009,296605,4.516,13.446,432847,151036,281811,4.547,13.031,13767,0.414,26.062,13696,14098,75239
2011,15,22807,29359,484359,480787,2385,8.087,2650,8.986,58174,19290,38884,4.012,12.100,51340,17380,33960,3.615,10.678,6834,1.421,21.357,1662,1706,9275
2011,16,31130,37925,482427,484972,3830,9.999,4587,11.975,60522,20244,40278,4.174,12.479,65238,20131,45107,4.151,13.452,-4716,-0.972,24.959,2868,2958,12651
2011,17,217505,277990,5017498,4979315,27012,9.718,26974,9.704,618882,186309,432573,3.742,12.429,541244,173995,367249,3.494,10.870,77638,1.559,21.740,16774,17286,88309
2011,18,98511,132661,2432452,2414267,10982,8.257,11670,8.774,292362,80437,211925,3.332,12.110,254854,76063,178791,3.151,10.556,37508,1.554,21.112,7357,7681,40480
2011,19,55907,73502,1257576,1252093,5534,7.516,5782,7.853,134570,39078,95492,3.121,10.748,123406,36090,87316,2.882,9.856,11164,0.892,19.712,3645,3718,19008
2011,20,52698,68235,1126418,1126870,5702,8.331,6115,8.935,132890,45987,86903,4.081,11.793,133708,39288,94420,3.486,11.865,-818,-0.073,23.586,3993,4065,20369
2011,21,61684,82936,1447319,1444620,6776,8.145,7296,8.770,173586,51469,122117,3.563,12.016,167051,52500,114551,3.634,11.564,6535,0.452,23.127,4862,5028,29237
2011,22,73652,96237,1607064,1598924,8427,8.766,8218,8.549,208627,67760,140867,4.238,13.048,192142,51951,140191,3.249,12.017,16485,1.031,24.034,5368,5523,28065
2011,23,28359,35206,478353,478912,3150,8.903,3498,9.887,53109,17066,36043,3.563,11.090,54211,18237,35974,3.808,11.320,-1102,-0.230,22.179,2087,2180,10618
2011,24,94813,121211,2103285,2085768,11507,9.481,11818,9.737,272988,87037,185951,4.173,13.088,238342,74121,164221,3.554,11.427,34646,1.661,22.854,7415,7531,37880
2011,25,120752,153383,2969815,2951615,13456,8.780,13206,8.617,333957,91503,242454,3.100,11.314,297774,84107,213667,2.850,10.089,36183,1.226,20.177,7921,8051,41658
2011,26,150743,195928,3374034,3323571,17969,9.172,17918,9.146,477472,133429,344043,4.015,14.366,375617,122018,253599,3.671,11.302,101855,3.065,22.603,11337,11633,64786
2011,27,99852,128096,2390873,2370641,11514,8.990,11483,8.965,273310,75241,198069,3.174,11.529,232767,68216,164551,2.878,9.819,40543,1.710,19.637,7173,7375,37774
2011,28,41755,55422,893775,887785,4663,8.404,4794,8.640,107582,33657,73925,3.791,12.118,95771,28425,67346,3.202,10.788,11811,1.330,21.575,3155,3289,16537
2011,29,101298,133552,2277285,2277580,12321,9.189,13382,9.980,251491,76040,175451,3.339,11.042,251489,75030,176459,3.294,11.042,2,0.000,22.084,9050,9250,41335
2011,30,26485,31241,335060,336196,3046,9.709,3309,10.547,40953,12335,28618,3.669,12.181,43005,14019,28986,4.170,12.792,-2052,-0.610,24.363,2049,2098,8587
2011,31,37074,47137,757239,756099,3883,8.231,3959,8.392,84484,24442,60042,3.233,11.174,81582,24288,57294,3.212,10.790,2902,0.384,21.580,2455,2504,12275
2011,32,40467,52254,997946,1000483,6525,12.476,6617,12.652,131751,42069,89682,4.205,13.169,136515,47206,89309,4.718,13.645,-4764,-0.476,26.337,4406,4498,30500
2011,33,27392,33856,554929,559208,2830,8.323,3125,9.190,57221,16373,40848,2.928,10.233,65337,18318,47019,3.276,11.684,-8116,-1.451,20.465,2007,2035,9561
2011,34,169039,203947,3370757,3362974,20324,9.941,21304,10.421,421265,125931,295334,3.745,12.527,405205,135402,269803,4.026,12.049,16060,0.478,24.098,13884,14066,66830
2011,35,31634,40341,594332,594952,3780,9.353,3929,9.722,70109,21274,48835,3.576,11.784,71099,19359,51740,3.254,11.950,-990,-0.166,23.568,2572,2644,11743
2011,36,386187,461176,7334434,7279655,49595,10.790,46496,10.116,941993,305315,636678,4.194,12.940,831311,282767,548544,3.884,11.420,110682,1.520,22.839,31179,31571,147234
2011,37,148754,197777,3270491,3244439,19004,9.579,20251,10.207,424469,134082,290387,4.133,13.083,372100,117683,254417,3.627,11.469,52369,1.614,22.938,12803,13189,66197
2011,38,16318,20137,308702,302948,1916,9.616,1492,7.488,42414,12305,30109,4.062,14.000,31267,7932,23335,2.618,10.321,11147,3.680,20.642,938,954,4648
2011,39,168602,231066,4427505,4390344,18185,7.841,19910,8.585,543589,142401,401188,3.244,12.381,469578,146653,322925,3.340,10.696,74011,1.686,21.391,11903,12432,73573
2011,40,64644,83075,1261580,1249261,7495,9.026,7423,8.939,163959,48394,115565,3.874,13.124,139378,42589,96789,3.409,11.157,24581,1.968,22.314,4946,5103,23645
2011,41,77041,96523,1334968,1327731,9529,9.859,9796,10.135,167334,47943,119391,3.611,12.603,153143,50746,102397,3.822,11.534,14191,1.069,23.068,6240,6437,27325
2011,42,207346,273781,5056598,5010411,22254,8.133,21913,8.009,612500,184385,428115,3.680,12.225,519670,153726,365944,3.068,10.372,92830,1.853,20.744,13388,13736,70015
2011,44,21182,25171,403837,400545,2286,9.054,2440,9.664,49053,15437,33616,3.854,12.247,42117,15538,26579,3.879,10.515,6936,1.732,21.030,1513,1540,6823
2011,45,70386,93599,1532697,1519068,8475,9.010,9397,9.990,205707,63639,142068,4.189,13.542,178069,54835,123234,3.610,11.722,27638,1.819,23.445,6099,6279,32777
2011,46,19118,23200,327053,328472,1894,8.159,1924,8.288,34804,9987,24817,3.040,10.596,37737,10363,27374,3.155,11.489,-2933,-0.893,21.191,1237,1278,7018
2011,47,88889,122324,2307514,2291423,10658,8.675,11734,9.551,291366,79636,211730,3.475,12.716,258468,87037,171431,3.798,11.280,32898,1.436,22.560,7429,7674,42977
2011,48,356235,485774,8959044,8870330,50967,10.539,46662,9.648,1309555,430282,879273,4.851,14.763,1132382,342092,790290,3.857,12.766,177173,1.997,25.532,30087,30946,182164
2011,49,48823,60156,1021269,1016130,7315,12.183,7093,11.813,137863,46324,91539,4.559,13.567,127630,40319,87311,3.968,12.560,10233,1.007,25.121,4436,4540,24531
2011,50,16043,18903,255062,254724,1563,8.226,1760,9.262,27102,7191,19911,2.823,10.640,26334,8442,17892,3.314,10.338,768,0.302,20.677,1120,1141,4794
2011,51,132171,176320,3037571,3023249,17366,9.847,17435,9.886,397777,127991,269786,4.234,13.157,369176,110013,259163,3.639,12.211,28601,0.946,24.422,10709,11019,53427
2011,53,124228,155806,2285425,2272646,16038,10.245,17513,11.187,306946,92426,214520,4.067,13.506,280751,84503,196248,3.718,12.353,26195,1.153,24.707,11125,11464,48684
2011,54,26750,35930,572199,568543,2749,7.623,3015,8.360,69222,17930,51292,3.154,12.175,61615,16991,44624,2.989,10.837,7607,1.338,21.675,1977,2041,11415
2011,55,97019,126207,2351982,2335531,9512,7.504,10629,8.385,253908,63482,190426,2.718,10.872,220616,61580,159036,2.637,9.446,33292,1.425,18.892,6683,6915,34925
2011,56,15395,18151,205543,204079,1876,10.384,1705,9.438,29599,8787,20812,4.306,14.504,26495,8094,18401,3.966,12.983,3104,1.521,25.965,1083,1093,4518
2012,01,68004,91810,1586610,1588059,7849,8.547,7902,8.604,205162,59918,145244,3.773,12.919,208941,59205,149736,3.728,13.157,-3779,-0.238,25.838,4986,5120,30347
2012,02,13719,17420,257575,256254,1728,9.941,1653,9.510,37282,10587,26695,4.131,14.549,34527,7860,26667,3.067,13.474,2755,1.075,26.948,883,895,3446
2012,04,87971,117392,2139984,2129129,12977,11.062,12806,10.917,319409,103103,216306,4.842,15.002,299629,103689,195940,4.870,14.073,19780,0.929,28.146,7767,7992,42495
2012,05,45708,59859,973813,975461,5057,8.443,5132,8.568,116848,30269,86579,3.103,11.979,120221,36565,83656,3.748,12.325,-3373,-0.346,23.957,3300,3378,18817
2012,06,606523,766165,12815373,12676742,84832,11.132,76632,10.056,1863421,555608,1307813,4.383,14.700,1585223,537240,1047983,4.238,12.505,278198,2.195,25.010,47010,48154,269492
2012,08,107375,133395,1989863,1962045,15110,11.366,14193,10.677,293295,94712,198583,4.827,14.948,238284,83560,154724,4.259,12.145,55011,2.804,24.289,8425,8615,42557
2012,09,64409,80772,1458243,1444760,7063,8.760,6770,8.397,182782,50716,132066,3.510,12.651,155435,47867,107568,3.313,10.759,27347,1.893,21.517,4062,4132,22298
2012,10,16864,21495,360362,358755,2105,9.791,2114,9.833,48218,16102,32116,4.488,13.440,45509,16677,28832,4.649,12.685,2709,0.755,25.371,1190,1228,6302
2012,11,15638,19993,478681,474436,1839,9.194,1857,9.284,65028,17258,47770,3.638,13.706,56318,19089,37229,4.024,11.871,8710,1.836,23.741,863,881,10315
2012,12,355871,446792,6891848,6769756,58135,13.157,48259,10.922,1124811,407189,717622,6.015,16.615,880169,341889,538280,5.050,13.001,244642,3.614,26.003,30386,31139,209188
2012,13,147920,194623,3372420,3351066,21102,10.858,20534,10.566,473167,161249,311918,4.812,14.120,428426,160196,268230,4.780,12.785,44741,1.335,25.570,12292,12529,68046
2012,15,22686,29148,489420,485891,2324,7.944,2534,8.662,58599,17210,41389,3.542,12.060,51076,16274,34802,3.349,10.512,7523,1.548,21.024,1449,1479,7831
2012,16,31248,38030,494828,488621,3989,10.505,3876,10.207,71062,23233,47829,4.755,14.543,58395,22198,36197,4.543,11.951,12667,2.592,23.902,2368,2406,10503
2012,17,218472,278333,5093715,5055042,26663,9.586,26287,9.451,663232,195921,467311,3.876,13.120,585100,201852,383248,3.993,11.575,78132,1.546,23.149,15494,16032,86347
2012,18,98600,132831,2504650,2468540,11332,8.537,11147,8.398,337221,96815,240406,3.922,13.661,265060,82684,182376,3.350,10.738,72161,2.923,21.475,6654,6880,41082
2012,19,56139,73776,1284141,1271703,5739,7.794,5448,7.399,148962,37155,111807,2.922,11.714,124119,39082,85037,3.073,9.760,24843,1.954,19.520,3318,3391,18239
2012,20,52640,68141,1146808,1136424,5692,8.349,5768,8.460,144992,43709,101283,3.846,12.759,123787,38331,85456,3.373,10.893,21205,1.866,21.785,3453,3594,19382
2012,21,61602,83038,1479956,1463828,7016,8.455,6893,8.307,197788,58024,139764,3.964,13.512,165478,51534,113944,3.520,11.304,32310,2.207,22.609,4234,4377,23162
2012,22,73961,96749,1632398,1618239,8602,8.915,8075,8.369,223456,65764,157692,4.064,13.809,195873,56887,138986,3.515,12.104,27583,1.705,24.208,4919,5086,30116
2012,23,28247,35122,484124,481205,3191,9.075,3269,9.297,56652,17213,39439,3.577,11.773,51143,16119,35024,3.350,10.628,5509,1.145,21.256,1934,2009,8764
2012,24,95637,121990,2138727,2122066,11511,9.467,10725,8.820,283377,81972,201405,3.863,13.354,249412,79203,170209,3.732,11.753,33965,1.601,23.507,6219,6375,34394
2012,25,122171,154560,3034067,3002493,14056,9.129,12870,8.359,358424,91990,266434,3.064,11.938,294839,96323,198516,3.208,9.820,63585,2.118,19.640,7430,7650,45506
2012,26,151467,196073,3457355,3414314,17171,8.761,16996,8.672,470099,118671,351428,3.476,13.768,386493,138367,248126,4.053,11.320,83606,2.449,22.640,10205,10516,74542
2012,27,100262,128409,2458099,2424329,11315,8.823,10972,8.556,309520,74325,235195,3.066,12.767,240005,76677,163328,3.163,9.900,69515,2.867,19.800,6435,6633,42514
2012,28,41394,55107,898859,896170,4383,7.933,4672,8.456,101572,29727,71845,3.317,11.334,96087,26443,69644,2.951,10.722,5485,0.612,21.444,2991,3055,15047
2012,29,101163,133285,2310992,2294558,12679,9.504,12929,9.691,288164,84791,203373,3.695,12.559,255981,78699,177282,3.430,11.156,32183,1.403,22.312,8196,8561,39069
2012,30,26782,31582,341186,338105,3267,10.402,2919,9.294,44611,13968,30643,4.131,13.194,38419,12011,26408,3.552,11.363,6192,1.831,22.726,1744,1772,6742
2012,31,37382,47448,772789,764959,3933,8.317,3613,7.640,93529,25976,67553,3.396,12.227,78193,21558,56635,2.818,10.222,15336,2.005,20.444,2201,2245,11860
2012,32,40941,52712,1017522,1007758,6505,12.378,6185,11.769,143225,48282,94943,4.791,14.212,123454,46763,76691,4.640,12.250,19771,1.962,24.501,3928,4082,28165
2012,33,27508,34052,548282,551753,3105,9.145,2905,8.556,61497,19038,42459,3.450,11.146,67965,27586,40379,5.000,12.318,-6468,-1.172,22.291,1770,1819,10553
2012,34,170862,205740,3428654,3401966,21627,10.559,19804,9.669,458994,137837,321157,4.052,13.492,405711,134662,271049,3.958,11.926,53283,1.566,23.852,12612,12825,66319
2012,35,31616,40327,592591,593614,3754,9.309,3753,9.307,75540,24747,50793,4.169,12.725,77558,24289,53269,4.092,13.065,-2018,-0.340,25.451,2314,2420,11000
2012,36,392118,467475,7491806,7411284,50675,10.914,44321,9.546,968972,289736,679236,3.909,13.074,807157,267392,539765,3.608,10.891,161815,2.183,21.782,30054,30507,146599
2012,37,149422,198773,3332011,3298238,19458,9.814,18430,9.296,443192,130164,313028,3.946,13.437,375680,122839,252841,3.724,11.390,67512,2.047,22.781,11156,11415,62681
2012,38,16983,20927,331673,320317,2286,11.135,1491,7.263,55272,16189,39083,5.054,17.255,32050,9747,22303,3.043,10.006,23222,7.250,20.011,975,991,5708
2012,39,168665,231049,4525541,4476285,18946,8.200,18918,8.188,591059,156290,434769,3.492,13.204,490524,158195,332329,3.534,10.958,100535,2.246,21.917,10941,11361,74702
2012,40,65155,83739,1294559,1278964,7797,9.349,7122,8.539,181371,58497,122874,4.574,14.181,150193,47318,102875,3.700,11.743,31178,2.438,23.487,4475,4604,24376
2012,41,77544,96830,1359430,1346967,9652,9.985,9329,9.651,177395,52769,124626,3.918,13.170,152501,47345,105156,3.515,11.322,24894,1.848,22.644,5487,5575,25008
2012,42,208231,274298,5145124,5101402,22261,8.124,21721,7.927,630756,172845,457911,3.388,12.364,541987,169463,372524,3.322,10.624,88769,1.740,21.249,12719,13126,76987
2012,44,21218,25195,405153,404668,2337,9.280,2313,9.185,46744,14023,32721,3.465,11.551,46071,13019,33052,3.217,11.385,673,0.166,22.770,1396,1414,6758
2012,45,70481,93623,1558686,1543122,8350,8.923,8251,8.818,204575,58135,146440,3.767,13.257,173447,52998,120449,3.434,11.240,31128,2.017,22.480,5010,5149,24895
2012,46,19255,23460,335608,331346,2103,9.015,1836,7.871,42377,13235,29142,3.994,12.789,33670,10037,23633,3.029,10.162,8707,2.628,20.323,1206,1225,5337
2012,47,88587,122175,2364863,2337361,10671,8.729,10812,8.844,310490,87129,223361,3.728,13.284,255862,80058,175804,3.425,10.947,54628,2.337,21.893,6662,6832,39644
2012,48,363094,493816,9318290,9144582,53255,10.874,45137,9.216,1452323,466343,985980,5.100,15.882,1100938,369391,731547,4.039,12.039,351385,3.843,24.078,27443,28475,181431
2012,49,49779,61294,1060002,1040710,7613,12.537,6472,10.658,157122,48459,108663,4.656,15.098,118242,37185,81057,3.573,11.362,38880,3.736,22.723,4063,4155,22776
2012,50,16063,18960,265688,260288,1671,8.827,1612,8.515,36624,9670,26954,3.715,14.071,26190,8326,17864,3.199,10.062,10434,4.009,20.124,1026,1052,5007
2012,51,132786,176744,3092782,3066164,16652,9.434,16202,9.179,437803,121851,315952,3.974,14.279,383573,115189,268384,3.757,12.510,54230,1.769,25.020,9459,9722,49482
2012,53,124494,155922,2317324,2300851,16091,10.324,15962,10.241,308820,90917,217903,3.951,13.422,275432,84619,190813,3.678,11.971,33388,1.451,23.942,9622,9818,46709
2012,54,26549,35711,582689,577326,2651,7.401,2868,8.007,73335,19010,54325,3.293,12.703,62502,19935,42567,3.453,10.826,10833,1.876,21.652,1736,1790,8748
2012,55,96784,126068,2385981,2369746,9992,7.922,10105,8.012,266127,70541,195586,2.977,11.230,233571,68317,165254,2.883,9.856,32556,1.374,19.713,6163,6342,35153
2012,56,15562,18344,212867,209886,1871,10.254,1675,9.180,32302,9953,22349,4.742,15.390,26431,9721,16710,4.632,12.593,5871,2.797,25.186,1074,1106,5468
2013,01,67615,91425,1597356,1591038,7444,8.126,7803,8.518,194114,53886,140228,3.387,12.200,181502,62680,118822,3.940,11.408,12612,0.793,22.816,4867,4954,30601
2013,02,13799,17542,264968,261255,1749,10.005,1626,9.302,34459,9743,24716,3.729,13.190,27194,7173,20021,2.746,10.409,7265,2.781,20.818,927,945,3299
2013,04,88748,118468,2188065,2163133,13076,11.090,11965,10.147,310350,103416,206934,4.781,14.347,260322,87507,172815,4.045,12.034,50028,2.313,24.069,7351,7443,43397
2013,05,45563,59902,975156,974849,5215,8.708,5183,8.655,116623,36647,79976,3.759,11.963,115602,42291,73311,4.338,11.858,1021,0.105,23.717,3370,3484,21052
2013,06,612090,772450,13236278,13022370,84097,10.933,77560,10.083,1969673,646465,1323208,4.964,15.125,1540027,558019,982008,4.285,11.826,429646,3.299,23.652,48367,49241,279265
2013,08,108949,135168,2045794,2018058,15547,11.579,13740,10.234,300099,95136,204963,4.714,14.871,244351,86887,157464,4.305,12.108,55748,2.762,24.216,8357,8446,43817
2013,09,64187,80731,1459612,1458886,6948,8.606,6961,8.622,159802,47384,112418,3.248,10.954,158379,48652,109727,3.335,10.856,1423,0.098,21.712,4225,4284,22394
2013,10,16883,21562,372042,366138,2056,9.556,1962,9.119,52710,17858,34852,4.877,14.396,41320,14182,27138,3.873,11.285,11390,3.111,22.571,1131,1143,5890
2013,11,15807,20370,486130,482256,2156,10.686,1769,8.768,56451,19283,37168,3.999,11.706,49103,14762,34341,3.061,10.182,7348,1.524,20.364,886,893,6321
2013,12,362091,453765,7112543,7021839,55939,12.424,48891,10.859,1071981,388096,683885,5.527,15.266,889461,323230,566231,4.603,12.667,182520,2.599,25.334,31490,31935,163944
2013,13,148978,195956,3444315,3408065,20517,10.507,19146,9.805,467785,141380,326405,4.148,13.726,395744,147046,248698,4.315,11.612,72041,2.114,23.224,11762,11944,67799
2013,15,22731,29222,502932,496295,2482,8.506,2395,8.208,61615,19332,42283,3.895,12.415,48381,19043,29338,3.837,9.748,13234,2.667,19.497,1407,1454,10420
2013,16,31490,38322,512983,504223,4031,10.561,3728,9.767,73299,22723,50576,4.507,14.537,56156,21674,34482,4.298,11.137,17143,3.400,22.274,2398,2415,11553
2013,17,218219,278384,5152147,5121731,26192,9.411,26072,9.367,634066,195392,438674,3.815,12.380,574838,194717,380121,3.802,11.224,59228,1.156,22.447,15904,16198,99796
2013,18,98013,132203,2543760,2524469,10304,7.776,10907,8.231,301348,80883,220465,3.204,11.937,262941,79182,183759,3.137,10.416,38407,1.521,20.831,6765,6866,41355
2013,19,55596,73541,1297739,1290706,5405,7.339,5628,7.641,136246,39110,97136,3.030,10.556,122077,32890,89187,2.548,9.458,14169,1.098,18.916,3436,3482,17271
2013,20,52254,67809,1161037,1152694,5444,8.010,5751,8.462,139863,40416,99447,3.506,12.134,123906,39352,84554,3.414,10.749,15957,1.384,21.499,3553,3586,19942
2013,21,61693,83386,1504530,1492894,7325,8.805,6933,8.334,193392,63365,130027,4.244,12.954,169847,51723,118124,3.465,11.377,23545,1.577,22.754,4327,4393,25294
2013,22,73987,96850,1670852,1651228,8128,8.397,8027,8.292,240831,73104,167727,4.427,14.585,200564,74325,126239,4.501,12.146,40267,2.439,24.293,5018,5094,37672
2013,23,28125,35076,484586,485003,3069,8.746,3101,8.837,54168,15932,38236,3.285,11.169,54769,19225,35544,3.964,11.293,-601,-0.124,22.337,1789,1822,9716
2013,24,95774,122621,2173698,2156276,11553,9.447,10890,8.905,284851,95869,188982,4.446,13.210,250661,83484,167177,3.872,11.625,34190,1.586,23.249,6462,6616,45091
2013,25,122580,155264,3082680,3058937,13718,8.857,12948,8.360,348185,101352,246833,3.313,11.383,300292,96008,204284,3.139,9.817,47893,1.566,19.634,7670,7819,41678
2013,26,151231,195661,3510022,3475652,16461,8.405,16817,8.587,436399,126670,309729,3.644,12.556,367817,115047,252770,3.310,10.583,68582,1.973,21.165,10345,10466,61190
2013,27,100279,128884,2507734,2488879,11140,8.661,10611,8.250,301155,79009,222146,3.174,12.100,264209,71078,193131,2.856,10.616,36946,1.484,21.231,6374,6432,35285
2013,28,41125,54861,897853,896469,4242,7.720,4414,8.033,97393,29287,68106,3.267,10.864,94272,27509,66763,3.069,10.516,3121,0.348,21.032,2902,2950,16935
2013,29,103076,135461,2347543,2330936,13781,10.237,12090,8.981,278657,87807,190850,3.767,11.955,244911,78522,166389,3.369,10.507,33746,1.448,21.014,7652,7815,38199
2013,30,26976,31843,352379,346616,3227,10.176,2962,9.341,49041,18037,31004,5.204,14.149,37836,12808,25028,3.695,10.916,11205,3.233,21.832,1872,1899,7821
2013,31,37333,47566,777105,775270,3839,8.082,3708,7.806,87937,24964,62973,3.220,11.343,84641,26212,58429,3.381,10.918,3296,0.425,21.835,2287,2313,12902
2013,32,41468,53322,1050439,1033287,6547,12.358,5859,11.059,162510,58433,104077,5.655,15.727,128731,49342,79389,4.775,12.458,33779,3.269,24.917,3848,3939,25939
2013,33,27419,34103,550757,549511,2883,8.461,2824,8.288,62264,19263,43001,3.505,11.331,59410,19112,40298,3.478,10.811,2854,0.519,21.623,1784,1800,8575
2013,34,171131,206475,3466248,3446699,20848,10.115,20099,9.752,460839,137746,323093,3.996,13.370,422094,143408,278686,4.161,12.246,38745,1.124,24.493,13079,13281,73943
2013,35,31461,40202,592449,592594,3610,8.969,3704,9.203,79414,28512,50902,4.811,13.401,79434,25977,53457,4.384,13.404,-20,-0.003,26.802,2347,2385,13377
2013,36,394909,470063,7626544,7563347,49041,10.463,46327,9.884,978350,312830,665520,4.136,12.935,851333,287600,563733,3.803,11.256,127017,1.679,22.512,30822,31288,162497
2013,37,149525,199550,3390993,3359842,18909,9.496,18074,9.076,441142,145265,295877,4.324,13.130,377616,125255,252361,3.728,11.239,63526,1.891,22.478,11311,11476,59491
2013,38,17345,21479,342644,337033,2265,10.684,1706,8.047,52402,18627,33775,5.527,15.548,41447,15292,26155,4.537,12.298,10955,3.250,24.595,1124,1127,7187
2013,39,167458,230255,4554797,4540778,18059,7.831,18768,8.138,543405,152360,391045,3.355,11.967,514684,172367,342317,3.796,11.335,28721,0.633,22.669,11141,11398,68227
2013,40,65520,84237,1319405,1306707,7643,9.101,7121,8.480,175392,57266,118126,4.382,13.422,149837,51662,98175,3.954,11.467,25555,1.956,22.934,4521,4637,27320
2013,41,78342,97925,1398488,1379066,9824,10.090,8704,8.940,183878,54994,128884,3.988,13.334,145576,47777,97799,3.464,10.556,38302,2.777,21.112,5371,5457,24860
2013,42,207558,274980,5158236,5153082,22366,8.143,21747,7.917,587324,180512,406812,3.503,11.398,577770,171703,406067,3.332,11.212,9554,0.185,22.424,13105,13288,88298
2013,44,21068,25123,409028,407084,2175,8.646,2243,8.916,45314,12741,32573,3.130,11.131,41126,13024,28102,3.199,10.103,4188,1.029,20.205,1400,1417,7188
2013,45,70682,93836,1583098,1570684,8333,8.892,8082,8.624,193986,57874,136112,3.685,12.350,168851,50518,118333,3.216,10.750,25135,1.600,21.500,5063,5176,25467
2013,46,19315,23585,340511,337921,1941,8.253,1807,7.683,40460,10429,30031,3.086,11.973,35289,12364,22925,3.659,10.443,5171,1.530,20.886,1155,1163,5545
2013,47,88671,122530,2407942,2386488,10924,8.930,10521,8.601,313735,92158,221577,3.862,13.146,269968,82882,187086,3.473,11.312,43767,1.834,22.625,6524,6682,38885
2013,48,369218,502054,9634995,9482463,53008,10.647,44636,8.965,1451040,463497,987543,4.888,15.302,1145538,380402,765136,4.012,12.081,305502,3.222,24.161,27842,28423,177787
2013,49,50854,62613,1090134,1074432,7476,12.069,6139,9.910,159255,56345,102910,5.244,14.822,129537,47958,81579,4.464,12.056,29718,2.766,24.113,3747,3794,22040
2013,50,15934,18853,256110,260159,1440,7.618,1537,8.132,28207,7956,20251,3.058,10.842,35797,17252,18545,6.631,13.760,-7590,-2.917,21.684,968,968,13730
2013,51,133192,177643,3115064,3100196,16999,9.595,16051,9.060,411182,133454,277728,4.305,13.263,383093,122388,260705,3.948,12.357,28089,0.906,24.714,9249,9419,51466
2013,53,125777,157412,2408701,2372888,16674,10.645,15133,9.661,348593,121493,227100,5.120,14.691,277410,94437,182973,3.980,11.691,71183,3.000,23.382,9379,9520,43883
2013,54,26027,35233,577961,579380,2525,7.122,2969,8.374,65765,18515,47250,3.196,11.351,68498,23505,44993,4.057,11.823,-2733,-0.472,22.702,1817,1839,9868
2013,55,96130,125583,2408334,2396918,9627,7.652,10077,8.010,257412,67602,189810,2.820,10.739,234246,68800,165446,2.870,9.773,23166,0.966,19.546,6053,6157,34119
2013,56,15494,18336,213295,212923,1745,9.518,1741,9.496,28628,10388,18240,4.879,13.445,27958,9252,18706,4.345,13.131,670,0.315,26.261,1122,1134,5182
2014,01,67517,91824,1600965,1597659,7429,8.107,7051,7.695,190219,61160,129059,3.828,11.906,184135,53503,130632,3.349,11.525,6084,0.381,23.051,4517,4638,26416
2014,02,13824,17719,264091,263801,1763,9.999,1588,9.007,37109,13052,24057,4.948,14.067,36397,10709,25688,4.059,13.797,712,0.270,27.594,947,954,3925
2014,04,89711,120422,2242326,2216249,13398,11.216,11469,9.601,340008,114037,225971,5.145,15.342,287317,86791,200526,3.916,12.964,52691,2.377,25.928,7192,7321,43402
2014,05,45450,59927,984978,980345,4889,8.160,4867,8.123,113948,35955,77993,3.668,11.623,104813,37365,67448,3.811,10.691,9135,0.932,21.383,3236,3296,16490
2014,06,623004,786686,13593874,13410294,87998,11.287,73911,9.480,1985662,649367,1336295,4.842,14.807,1622224,572448,1049776,4.269,12.097,363438,2.710,24.194,47268,48184,270015
2014,08,110986,138032,2114086,2079659,16099,11.785,13251,9.700,316300,107341,208959,5.161,15.209,246848,83075,163773,3.995,11.870,69452,3.340,23.739,8402,8475,41130
2014,09,64009,80908,1474807,1467585,6888,8.521,6734,8.331,168578,51586,116992,3.515,11.487,155019,53979,101040,3.678,10.563,13559,0.924,21.126,4173,4214,20212
2014,10,16977,21646,384721,378499,2040,9.442,1958,9.063,54596,14804,39792,3.911,14.424,42062,16316,25746,4.311,11.113,12534,3.312,22.226,1116,1138,5589
2014,11,15968,20630,492918,489167,1994,9.727,1734,8.459,60131,20214,39917,4.132,12.293,52581,14147,38434,2.892,10.749,7550,1.543,21.498,924,938,5897
2014,12,368185,462106,7353791,7222033,57244,12.500,48953,10.689,1137179,405280,731899,5.612,15.746,873712,315123,558589,4.363,12.098,263467,3.648,24.196,31876,32411,171361
2014,13,150245,198583,3515143,3479678,21161,10.726,18565,9.410,471252,148054,323198,4.255,13.543,397990,148759,249231,4.275,11.438,73262,2.105,22.875,11734,11950,84193
2014,15,22708,29426,519870,511371,2489,8.487,2288,7.802,63086,23267,39819,4.550,12.337,46523,14917,31606,2.917,9.098,16563,3.239,18.195,1504,1521,8105
2014,16,32211,39223,530655,521553,4246,10.951,3346,8.630,77385,23016,54369,4.413,14.837,59228,23125,36103,4.434,11.356,18157,3.481,22.712,2156,2200,9280
2014,17,218155,279413,5285387,5220047,26152,9.376,25180,9.027,673604,232985,440619,4.463,12.904,544622,187437,357185,3.591,10.433,128982,2.471,20.867,15625,15890,84870
2014,18,97403,132165,2603173,2573280,10618,8.033,10657,8.062,309258,87258,222000,3.391,12.018,250198,78510,171688,3.051,9.723,59060,2.295,19.446,6646,6764,40188
2014,19,55497,73573,1306392,1302138,5267,7.160,5239,7.122,124533,37247,87286,2.860,9.564,116039,35056,80983,2.692,8.911,8494,0.652,17.823,3323,3419,17443
2014,20,52411,68226,1180781,1170446,5735,8.431,5328,7.833,147637,49351,98286,4.216,12.614,127215,41305,85910,3.529,10.869,20422,1.745,21.738,3362,3440,18466
2014,21,62157,84411,1533026,1519215,7765,9.254,6763,8.060,198735,67074,131661,4.415,13.081,169719,48543,121176,3.195,11.171,29016,1.910,22.343,4281,4381,24280
2014,22,74023,97401,1701816,1689170,8222,8.465,7679,7.906,212152,68984,143168,4.084,12.560,186313,58531,127782,3.465,11.030,25839,1.530,22.060,4877,4973,28179
2014,23,28224,35325,491207,488001,3180,9.034,2934,8.335,56161,21168,34993,4.338,11.508,49876,15387,34489,3.153,10.220,6285,1.288,20.441,1735,1763,7287
2014,24,95934,123603,2199574,2186680,11754,9.547,10794,8.767,260057,79555,180502,3.638,11.893,234849,68204,166645,3.119,10.740,25208,1.153,21.480,6541,6612,33234
2014,25,123279,156383,3087365,3078033,13496,8.661,12387,7.949,336345,104741,231604,3.403,10.927,320460,84406,236054,2.742,10.411,15885,0.516,20.822,7673,7887,42441
2014,26,151171,196177,3582805,3544369,16549,8.447,16040,8.187,440035,123948,316087,3.497,12.415,361519,116994,244525,3.301,10.200,78516,2.215,20.400,10227,10451,62648
2014,27,100792,130365,2557258,2533807,11518,8.884,10080,7.775,286728,81335,205393,3.210,11.316,238947,71863,167084,2.836,9.430,47781,1.886,18.861,6284,6423,40097
2014,28,41087,55078,908237,903040,4420,8.040,4217,7.671,99071,31145,67926,3.449,10.971,88673,25701,62972,2.846,9.819,10398,1.151,19.639,2809,2863,14433
2014,29,105296,138400,2398526,2373633,14928,10.892,12240,8.931,284925,84863,200062,3.575,12.004,234742,73555,161187,3.099,9.890,50183,2.114,19.779,8057,8167,38126
2014,30,27116,32103,361448,356863,3130,9.789,2874,8.988,48606,14710,33896,4.122,13.620,39188,14702,24486,4.120,10.981,9418,2.639,21.962,1827,1842,7385
2014,31,37790,48182,791001,783477,3953,8.256,3351,6.999,86326,24862,61464,3.173,11.018,70959,23043,47916,2.941,9.057,15367,1.961,18.114,2071,2130,10563
2014,32,42492,54706,1086794,1069876,6973,12.908,5603,10.372,151490,51077,100413,4.774,14.160,117211,46598,70613,4.355,10.956,34279,3.204,21.911,3644,3682,21762
2014,33,27350,34318,562705,556597,2924,8.546,2716,7.938,64780,24988,39792,4.489,11.639,51873,17131,34742,3.078,9.320,12907,2.319,18.639,1716,1756,8214
2014,34,171070,207180,3503310,3489272,20760,10.037,20077,9.707,437928,147389,290539,4.224,12.551,408822,129599,279223,3.714,11.717,29106,0.834,23.433,13214,13389,69032
2014,35,31290,40193,615524,604021,3504,8.716,3518,8.751,87642,40023,47619,6.626,14.510,65584,20487,45097,3.392,10.858,22058,3.652,21.716,2306,2333,11015
2014,36,397272,473739,7807270,7721003,49598,10.510,45966,9.740,1017254,355593,661661,4.606,13.175,845099,287402,557697,3.722,10.945,172155,2.230,21.891,31695,32026,162876
2014,37,149938,200627,3444588,3418268,18830,9.410,17776,8.884,418341,129283,289058,3.782,12.238,366955,131343,235612,3.842,10.735,51386,1.503,21.470,11132,11373,58966
2014,38,17707,22066,357801,350134,2282,10.479,1705,7.829,53427,18521,34906,5.290,15.259,37909,11608,26301,3.315,10.827,15518,4.432,21.654,1171,1179,5954
2014,39,166713,230933,4613100,4585604,18053,7.828,17434,7.560,524468,160577,363891,3.502,11.437,469457,129567,339890,2.826,10.238,55011,1.200,20.475,10643,10951,64840
2014,40,65871,85015,1353627,1336322,7622,9.006,6860,8.105,179145,56051,123094,4.194,13.406,144369,48722,95647,3.646,10.803,34776,2.602,21.607,4584,4649,27729
2014,41,79364,99349,1435349,1417068,9917,10.053,8510,8.627,186125,56837,129288,4.011,13.135,149629,50067,99562,3.533,10.559,36496,2.575,21.118,5441,5514,23895
2014,42,207123,275340,5230799,5194750,22050,8.013,21712,7.890,579902,180386,399516,3.472,11.163,509938,158601,351337,3.053,9.816,69964,1.347,19.633,13106,13431,77055
2014,44,20980,25160,420020,414457,2215,8.810,2177,8.659,51062,17755,33307,4.284,12.320,39922,12733,27189,3.072,9.632,11140,2.688,19.265,1355,1365,6784
2014,45,70999,94601,1611324,1591074,8702,9.236,7942,8.429,200189,63106,137083,3.966,12.582,159722,50314,109408,3.162,10.039,40467,2.543,20.077,5057,5152,25603
2014,46,19366,23689,347675,344089,1888,7.987,1785,7.552,38598,11297,27301,3.283,11.217,31309,8820,22489,2.563,9.099,7289,2.118,18.198,1183,1203,5439
2014,47,88666,123382,2458839,2434081,10983,8.931,10170,8.270,297859,92337,205522,3.794,12.237,247875,78624,169251,3.230,10.184,49984,2.054,20.367,6433,6555,36315
2014,48,376035,512866,9914470,9777205,55213,10.879,44490,8.766,1454276,495706,958570,5.070,14.874,1179155,414906,764249,4.244,12.060,275121,2.814,24.120,28049,28772,182025
2014,49,52097,64131,1138819,1117743,7632,12.042,6125,9.664,167093,57170,109923,5.115,14.949,124149,39955,84194,3.575,11.107,42944,3.842,22.214,3875,3935,22345
2014,50,15921,18866,260549,258897,1519,8.053,1512,8.016,28034,8238,19796,3.182,10.828,24772,7895,16877,3.049,9.568,3262,1.260,19.137,956,991,5467
2014,51,133602,179126,3140932,3126646,16801,9.418,15332,8.595,389869,129194,260675,4.132,12.469,359828,106005,253823,3.390,11.508,30041,0.961,23.017,9504,9659,45664
2014,53,127571,159734,2477277,2443120,16559,10.441,14270,8.998,322555,96166,226389,3.936,13.203,252767,80706,172061,3.303,10.346,69788,2.857,20.692,9092,9239,41688
2014,54,25509,34853,574029,575872,2439,6.959,2833,8.083,63827,20793,43034,3.611,11.084,67068,20547,46521,3.568,11.646,-3241,-0.563,22.167,1771,1799,9235
2014,55,96169,126171,2438325,2412793,9785,7.773,9226,7.329,259296,72913,186383,3.022,10.747,208549,60018,148531,2.487,8.643,50747,2.103,17.287,5809,5937,30919
2014,56,15530,18454,219146,216219,1718,9.340,1597,8.682,30760,8988,21772,4.157,14.226,24648,7762,16886,3.590,11.400,6112,2.827,22.799,1050,1053,3635
2015,01,67442,92446,1637725,1619025,7824,8.491,7215,7.830,199131,64341,134790,3.974,12.299,162466,50950,111516,3.147,10.035,36665,2.265,20.070,4614,4771,27391
2015,02,13916,17897,266548,265255,1757,9.867,1576,8.851,36225,10318,25907,3.890,13.657,33830,9325,24505,3.515,12.754,2395,0.903,25.508,933,945,4069
2015,04,90991,122127,2312534,2277425,13382,11.035,11672,9.625,332213,113405,218808,4.980,14.587,262238,91242,170996,4.006,11.515,69975,3.073,23.029,7091,7284,41606
2015,05,45388,60159,998214,991777,5116,8.520,4895,8.152,120146,39423,80723,3.975,12.114,107710,36133,71577,3.643,10.860,12436,1.254,21.721,3097,3143,17292
2015,06,633030,800768,14071898,13837405,89248,11.244,75223,9.477,2026439,686989,1339450,4.965,14.645,1554879,539599,1015280,3.900,11.237,471560,3.408,22.474,49005,49911,299983
2015,08,113172,140858,2194516,2150528,16724,11.994,13880,9.954,333311,113228,220083,5.265,15.499,245497,87786,157711,4.082,11.416,87814,4.083,22.831,8676,8777,45631
2015,09,63778,81028,1498026,1487956,6887,8.506,6773,8.365,176554,58177,118377,3.910,11.866,156864,45579,111285,3.063,10.542,19690,1.323,21.084,4153,4213,24582
2015,10,17146,21875,391678,388477,2175,9.990,1967,9.035,52655,16342,36313,4.207,13.554,45943,14876,31067,3.829,11.826,6712,1.728,23.653,1129,1149,6200
2015,11,16197,20856,508079,500494,2207,10.640,1980,9.546,73887,27147,46740,5.424,14.763,57855,17825,40030,3.561,11.560,16032,3.203,23.119,982,997,7506
2015,12,376405,472860,7700573,7539278,59392,12.704,48670,10.411,1167509,408056,759453,5.412,15.486,842472,328901,513571,4.362,11.174,325037,4.311,22.349,31445,32079,180318
2015,13,152389,201782,3651704,3586387,21695,10.837,18507,9.245,528544,179769,348775,5.013,14.738,398035,138911,259124,3.873,11.098,130509,3.639,22.197,11442,11738,72802
2015,15,22743,29561,523961,521862,2484,8.422,2348,7.961,55133,17001,38132,3.258,10.565,51420,16824,34596,3.224,9.853,3713,0.711,19.706,1482,1501,9280
2015,16,32794,40036,549580,540374,4259,10.746,3457,8.722,73481,23323,50158,4.316,13.598,55527,20156,35371,3.730,10.276,17954,3.323,20.551,2206,2238,10256
2015,17,219596,281445,5358132,5304160,26693,9.518,24685,8.802,710532,204002,506530,3.846,13.396,602305,218269,384036,4.115,11.355,108227,2.040,22.711,15059,15461,84724
2015,18,97712,133708,2670537,2636066,11535,8.677,9993,7.517,330885,99946,230939,3.791,12.552,260922,70424,190498,2.672,9.898,69963,2.654,19.796,6208,6398,38139
2015,19,55742,74136,1336830,1321828,5720,7.743,5196,7.034,143775,42484,101291,3.214,10.877,113028,33088,79940,2.503,8.551,30747,2.326,17.102,3237,3316,16575
2015,20,52426,68581,1193410,1186128,5780,8.450,5415,7.917,149956,48488,101468,4.088,12.642,136192,37379,98813,3.151,11.482,13764,1.160,22.964,3465,3576,19232
2015,21,62175,85104,1576810,1555638,7322,8.638,6647,7.842,194604,57877,136727,3.720,12.510,152112,45476,106636,2.923,9.778,42492,2.731,19.556,4277,4348,23774
2015,22,73905,97896,1714390,1707696,8410,8.613,7914,8.105,225418,75299,150119,4.409,13.200,214320,55603,158717,3.256,12.550,11098,0.650,25.100,5028,5127,29582
2015,23,28416,35633,499517,495304,3204,9.031,2893,8.154,58176,17905,40271,3.615,11.746,49446,17044,32402,3.441,9.983,8730,1.763,19.966,1774,1805,7869
2015,24,96099,124109,2225627,2212683,11371,9.181,10865,8.772,268862,91084,177778,4.116,12.151,242071,76779,165292,3.470,10.940,26791,1.211,21.880,6613,6730,36666
2015,25,123787,157324,3169374,3128813,13734,8.756,12804,8.163,373362,114810,258552,3.669,11.933,291386,91966,199420,2.939,9.313,81976,2.620,18.626,7782,7931,46042
2015,26,151922,198259,3716216,3655210,18046,9.150,15972,8.098,483074,148598,334476,4.065,13.216,360197,108109,252088,2.958,9.854,122877,3.362,19.709,10195,10464,61131
2015,27,101394,131724,2579486,2557006,11727,8.948,10387,7.926,298713,90232,208481,3.529,11.682,254495,71629,182866,2.801,9.953,44218,1.729,19.906,6373,6570,35728
2015,28,40925,55096,921415,914881,4318,7.838,4305,7.815,109136,38814,70322,4.243,11.929,95777,26843,68934,2.934,10.469,13359,1.460,20.938,2853,2909,16351
2015,29,107538,141209,2444161,2421261,15447,11.045,12738,9.108,310920,106165,204755,4.385,12.841,265786,87578,178208,3.617,10.977,45134,1.864,21.954,8193,8400,42363
2015,30,27498,32572,370730,366134,3213,9.933,2760,8.533,48488,15670,32818,4.280,13.243,38764,12347,26417,3.372,10.587,9724,2.656,21.175,1833,1874,7631
2015,31,38089,48816,807256,799250,4148,8.550,3544,7.305,91470,29594,61876,3.703,11.444,75895,22807,53088,2.854,9.496,15575,1.949,18.992,2203,2241,11692
2015,32,43591,56325,1125003,1105838,7159,12.890,5585,10.056,165994,67467,98527,6.101,15.011,126651,39753,86898,3.595,11.453,39343,3.558,22.906,3685,3758,23437
2015,33,27350,34489,577125,569829,2866,8.330,2698,7.842,65830,18905,46925,3.318,11.553,51350,14262,37088,2.503,9.011,14480,2.541,18.023,1723,1751,8493
2015,34,170445,207121,3542291,3518590,20220,9.761,20266,9.784,472027,164758,307269,4.683,13.415,422708,144772,277936,4.114,12.014,49319,1.402,24.027,13387,13586,84384
2015,35,31150,40342,626222,620372,3673,9.121,3526,8.756,77722,27541,50181,4.439,12.528,65983,19867,46116,3.202,10.636,11739,1.892,21.272,2214,2235,10772
2015,36,398948,476133,7952113,7879615,49092,10.336,46740,9.841,1030162,348243,681919,4.420,13.074,885243,292606,592637,3.713,11.235,144919,1.839,22.469,32072,32546,164227
2015,37,151782,203298,3557844,3500417,19485,9.648,16817,8.327,462884,152543,310341,4.358,13.224,348782,116911,231871,3.340,9.964,114102,3.260,19.928,10346,10517,60771
2015,38,17934,22481,363493,360696,2227,9.996,1823,8.183,46374,17568,28806,4.871,12.857,40884,10443,30441,2.895,11.335,5490,1.522,22.670,1255,1277,6677
2015,39,166588,232571,4685950,4650701,19294,8.325,17672,7.625,559934,170721,389213,3.671,12.040,489333,141928,347405,3.052,10.522,70601,1.518,21.043,10553,10853,73008
2015,40,65933,85617,1366644,1359785,7846,9.196,7250,8.498,173101,59810,113291,4.398,12.730,160680,54713,105967,4.024,11.817,12421,0.913,23.633,4779,4869,25866
2015,41,80950,101650,1492278,1464110,10391,10.339,8095,8.055,202309,62926,139383,4.298,13.818,146020,47449,98571,3.241,9.973,56289,3.845,19.947,5231,5288,26080
2015,42,206903,276231,5290142,5262905,22573,8.184,21721,7.875,607612,207093,400519,3.935,11.545,552103,173086,379017,3.289,10.490,55509,1.055,20.981,13048,13417,76879
2015,44,21182,25386,425330,422372,2318,9.172,2091,8.274,46137,13514,32623,3.200,10.923,39847,12060,27787,2.855,9.434,6290,1.489,18.868,1273,1294,7549
2015,45,71951,96085,1664696,1639141,9255,9.708,7749,8.128,212947,71774,141173,4.379,12.991,162311,51052,111259,3.115,9.902,50636,3.089,19.804,4951,5048,28029
2015,46,19596,24059,353352,350375,2099,8.790,1738,7.279,37030,11562,25468,3.300,10.569,31183,9798,21385,2.796,8.900,5847,1.669,17.800,1165,1190,6027
2015,47,88986,124858,2509963,2481920,11403,9.187,9931,8.001,310515,101150,209365,4.075,12.511,254475,79301,175174,3.195,10.253,56040,2.258,20.506,6303,6454,47009
2015,48,382583,522395,10248125,10090425,55689,10.758,46208,8.926,1503865,518866,984999,5.142,14.904,1188836,388802,800034,3.853,11.782,315029,3.122,23.564,29117,29965,189234
2015,49,53294,65817,1198487,1171832,7919,12.187,6239,9.602,182734,60393,122341,5.154,15.594,128999,40297,88702,3.439,11.008,53735,4.586,22.017,3985,4079,23511
2015,50,15982,18996,265949,263250,1496,7.902,1369,7.231,28246,8229,20017,3.126,10.730,22723,6269,16454,2.381,8.632,5523,2.098,17.263,921,932,3998
2015,51,134648,180775,3210056,3180631,17129,9.518,15509,8.618,410091,143161,266930,4.501,12.893,351584,111862,239722,3.517,11.054,58507,1.839,22.108,9296,9483,48926
2015,53,129906,163102,2554800,2514716,17537,10.864,14179,8.784,346146,115582,230564,4.596,13.765,265662,79825,185837,3.174,10.564,80484,3.201,21.129,9270,9415,44945
2015,54,25256,34746,568173,571690,2632,7.562,2752,7.907,61945,19017,42928,3.326,10.835,68362,18421,49941,3.222,11.958,-6417,-1.122,21.671,1758,1790,9325
2015,55,96669,127370,2490146,2464405,10239,8.077,9048,7.137,274256,77310,196946,3.137,11.129,221324,60265,161059,2.445,8.981,52932,2.148,17.962,5782,5887,33395
2015,56,15785,18732,220369,219686,1837,9.877,1569,8.436,29199,9640,19559,4.388,13.291,27869,7906,19963,3.599,12.686,1330,0.605,25.372,1032,1036,3852
2016,01,68087,93727,1672674,1655272,7799,8.379,6501,6.984,199540,66054,133486,3.991,12.055,163560,50744,112816,3.066,9.881,35980,2.174,19.762,4278,4393,24580
2016,02,14020,18107,265074,265925,1850,10.276,1642,9.121,34712,12087,22625,4.545,13.053,36489,10920,25569,4.106,13.722,-1777,-0.668,26.107,989,1011,6331
2016,04,92782,125127,2399844,2356962,13840,11.194,10853,8.778,371685,129390,242295,5.490,15.770,286768,106089,180679,4.501,12.167,84917,3.603,24.334,6829,7032,56825
2016,05,45694,60969,1021631,1009863,5482,9.052,4669,7.709,123840,41897,81943,4.149,12.263,100435,28377,72058,2.810,9.945,23405,2.318,19.891,3119,3164,17491
2016,06,644397,817096,14347825,14198900,91782,11.346,75459,9.328,2023790,653251,1370539,4.601,14.253,1718753,647888,1070865,4.563,12.105,305037,2.148,24.210,50088,51074,312508
2016,08,115786,144873,2253996,2224330,17575,12.302,13557,9.489,319340,117758,201582,5.294,14.357,260695,85615,175080,3.849,11.720,58645,2.637,23.440,8628,8777,47446
2016,09,64459,82498,1537974,1517877,7858,9.611,6390,7.815,186082,63249,122833,4.167,12.259,144727,43432,101295,2.861,9.535,41355,2.725,19.070,4114,4160,20408
2016,10,17490,22419,398809,395216,2288,10.332,1741,7.862,52769,15687,37082,3.969,13.352,45411,13182,32229,3.335,11.490,7358,1.862,22.980,1096,1115,6287
2016,11,16455,21520,520729,514691,2303,10.868,1643,7.754,64956,20230,44726,3.931,12.620,52838,12313,40525,2.392,10.266,12118,2.354,20.532,973,995,5889
2016,12,385850,487164,7946150,7830046,61251,12.760,46960,9.783,1140412,409392,731020,5.228,14.565,910916,339154,571762,4.331,11.634,229496,2.931,23.267,31460,31908,173535
2016,13,155311,206270,3772270,3717234,22203,10.882,17723,8.686,501835,169862,331973,4.570,13.500,391587,131444,260143,3.536,10.534,110248,2.966,21.069,11341,11606,71666
2016,15,22961,29965,529136,526628,2613,8.778,2215,7.441,58251,18366,39885,3.487,11.061,52821,13534,39287,2.570,10.030,5430,1.031,20.060,1395,1440,8151
2016,16,33503,41001,564793,556854,4470,11.035,3485,8.603,75550,23675,51875,4.252,13.567,59680,18766,40914,3.370,10.717,15870,2.850,21.435,2228,2273,9965
2016,17,221163,284422,5412996,5389207,26978,9.535,24016,8.488,654930,212509,442421,3.943,12.153,610246,164907,445339,3.060,11.323,44684,0.829,22.647,15528,15872,85988
2016,18,98232,135828,2731824,2701320,11511,8.540,9423,6.991,324365,99552,224813,3.685,12.008,263422,67933,195489,2.515,9.752,60943,2.256,19.503,6172,6351,37858
2016,19,55944,74978,1349412,1342813,5846,7.841,5013,6.723,137249,40277,96972,2.999,10.221,123800,31437,92363,2.341,9.219,13449,1.002,18.439,3243,3317,17882
2016,20,52638,69415,1191172,1191946,6087,8.822,5259,7.622,132269,46358,85911,3.889,11.097,133732,46297,87435,3.884,11.220,-1463,-0.123,22.194,3435,3560,23711
2016,21,62215,85626,1604806,1590821,7068,8.280,6536,7.657,189735,56862,132873,3.574,11.927,161745,47958,113787,3.015,10.167,27990,1.759,20.335,4335,4524,24765
2016,22,73800,98657,1697977,1706321,8576,8.726,7816,7.953,197316,71738,125578,4.204,11.564,214774,55523,159251,3.254,12.587,-17458,-1.023,23.128,5187,5304,31729
2016,23,29104,36470,510477,505294,3467,9.616,2635,7.308,56988,19005,37983,3.761,11.278,46647,15492,31155,3.066,9.232,10341,2.047,18.463,1702,1740,9032
2016,24,97125,126074,2273433,2250312,11848,9.472,9878,7.897,270826,84909,185917,3.773,12.035,225021,70206,154815,3.120,10.000,45805,2.035,19.999,6276,6404,36245
2016,25,125922,160736,3230219,3198032,15105,9.498,11693,7.353,369712,107999,261713,3.377,11.561,308126,83863,224263,2.622,9.635,61586,1.926,19.270,7729,7869,45797
2016,26,153350,200867,3808198,3763250,17703,8.871,15080,7.557,461613,139070,322543,3.695,12.266,371007,113650,257357,3.020,9.859,90606,2.408,19.717,9987,10270,70296
2016,27,102226,133796,2624998,2601161,12026,9.059,9936,7.485,314602,96042,218560,3.692,12.095,266355,82202,184153,3.160,10.240,48247,1.855,20.480,6512,6637,44324
2016,28,40941,55382,936551,929258,4450,8.055,4170,7.549,108588,33881,74707,3.646,11.685,94208,28001,66207,3.013,10.138,14380,1.547,20.276,2711,2785,14204
2016,29,109729,144707,2498720,2471278,15766,11.026,12334,8.626,298253,97049,201204,3.927,12.069,242645,74622,168023,3.020,9.819,55608,2.250,19.637,8327,8451,41587
2016,30,27697,32980,374840,372606,3176,9.691,2764,8.434,44202,15933,28269,4.276,11.863,40132,11932,28200,3.202,10.771,4070,1.092,21.541,1840,1847,7105
2016,31,38547,49549,821682,814478,4172,8.483,3436,6.986,88747,28153,60594,3.457,10.896,74589,22089,52500,2.712,9.158,14158,1.738,18.316,2178,2241,12198
2016,32,44730,57998,1161034,1145413,7235,12.656,5568,9.740,158665,57482,101183,5.018,13.852,128164,46045,82119,4.020,11.189,30501,2.663,22.379,3689,3781,28558
2016,33,27713,35086,594149,585744,3068,8.820,2468,7.095,66189,19008,47181,3.245,11.300,49433,14142,35291,2.414,8.439,16756,2.861,16.879,1673,1698,7991
2016,34,171728,209674,3619935,3583351,21296,10.218,18762,9.003,476120,150621,325499,4.203,13.287,401556,134735,266821,3.760,11.206,74564,2.081,22.412,12876,13011,73085
2016,35,31023,40435,630716,628572,3568,8.834,3473,8.599,75769,27057,48712,4.305,12.054,71697,21706,49991,3.453,11.406,4072,0.648,22.813,2220,2296,12138
2016,36,403160,482547,8113539,8032326,51383,10.720,44951,9.378,1019570,322961,696609,4.021,12.693,858303,308623,549680,3.842,10.686,161267,2.008,21.371,32400,32795,190915
2016,37,154855,208134,3672314,3615165,20708,10.066,15878,7.718,477071,154683,322388,4.279,13.196,364754,111582,253172,3.086,10.090,112317,3.107,20.179,10332,10539,68429
2016,38,17724,22455,345871,354976,1894,8.430,1919,8.541,34303,12583,21720,3.545,9.663,52528,10818,41710,3.048,14.798,-18225,-5.134,19.327,1327,1351,6512
2016,39,166653,235980,4776186,4735273,19699,8.408,16299,6.957,550629,166431,384198,3.515,11.628,469401,130556,338845,2.757,9.913,81228,1.715,19.826,10512,10851,69871
2016,40,65600,86102,1356442,1361408,7949,9.258,7463,8.692,163999,57619,106380,4.232,12.046,174741,46560,128181,3.420,12.835,-10742,-0.789,24.093,5017,5108,26533
2016,41,82660,103933,1546697,1521100,10657,10.367,8379,8.151,197742,61502,136240,4.043,13.000,147455,48953,98502,3.218,9.694,50287,3.306,19.388,5477,5574,26494
2016,42,208189,279539,5349486,5320862,23589,8.488,20300,7.305,605303,192034,413269,3.609,11.376,547183,166124,381059,3.122,10.284,58120,1.092,20.567,12855,13162,79335
2016,44,21516,25959,434810,430055,2571,10.014,2002,7.798,50413,16605,33808,3.861,11.722,41134,11408,29726,2.653,9.565,9279,2.158,19.130,1318,1333,6716
2016,45,73329,98465,1721507,1693949,9582,9.850,7207,7.409,226601,77871,148730,4.597,13.377,171673,47823,123850,2.823,10.134,54928,3.243,20.269,4740,4870,27484
2016,46,19770,24416,358833,356163,2091,8.626,1739,7.174,36024,10992,25032,3.086,10.114,30878,7776,23102,2.183,8.670,5146,1.445,17.339,1190,1205,5106
2016,47,89915,127180,2584982,2547021,11507,9.131,9191,7.293,323450,105080,218370,4.126,12.699,247790,70005,177785,2.749,9.729,75660,2.971,19.457,6069,6218,35804
2016,48,388412,534133,10443895,10346426,57976,10.975,46231,8.752,1448765,516473,932292,4.992,14.003,1254105,359868,894237,3.478,12.121,194660,1.881,24.242,30425,31360,200267
2016,49,54480,67594,1243565,1221596,8019,12.021,6246,9.363,172159,54211,117948,4.438,14.093,128405,42830,85575,3.506,10.511,43754,3.582,21.023,4016,4104,25417
2016,50,15989,19088,267194,266694,1504,7.899,1411,7.410,26362,7474,18888,2.802,9.885,25427,6821,18606,2.558,9.534,935,0.351,19.068,918,930,4000
2016,51,135895,183572,3271683,3243295,17569,9.644,14789,8.118,410594,133966,276628,4.131,12.660,353972,101926,252046,3.143,10.914,56622,1.746,21.828,9304,9542,50618
2016,53,132184,166437,2609777,2567135,17813,10.811,14461,8.777,347686,113140,234546,4.407,13.544,262923,87636,175287,3.414,10.242,84763,3.302,20.484,9496,9611,48261
2016,54,24944,34560,560979,564465,2476,7.145,2663,7.685,61264,18695,42569,3.312,10.853,68356,18221,50135,3.228,12.110,-7092,-1.256,21.707,1765,1815,11253
2016,55,97694,129945,2518615,2504575,11404,8.864,8838,6.869,276327,90398,185929,3.609,11.033,247886,66351,181535,2.649,9.897,28441,1.136,19.795,5725,5854,33511
2016,56,15586,18649,208985,214658,1791,9.583,1871,10.011,23783,9270,14513,4.319,11.080,35145,10004,25141,4.660,16.373,-11362,-5.293,22.159,1306,1317,6645
2017,01,68265,93916,1696233,1683039,7631,8.134,7439,7.929,221624,57453,164171,3.414,13.168,194617,59467,135150,3.533,11.563,27007,1.605,23.127,4504,4633,28632
2017,02,13983,18068,260545,262338,1759,9.727,1789,9.893,34183,8541,25642,3.256,13.030,37640,12517,25123,4.771,14.348,-3457,-1.318,26.060,1018,1034,4942
2017,04,94323,127155,2456130,2423101,13872,10.997,11849,9.393,359950,116966,242984,4.827,14.855,294325,102900,191425,4.247,12.147,65625,2.708,24.293,7063,7219,45509
2017,05,45819,61356,1028539,1020892,5331,8.717,4931,8.063,136059,42303,93756,4.144,13.327,120694,38129,82565,3.735,11.822,15365,1.505,23.645,3046,3141,18633
2017,06,652550,826725,14654515,14488096,89984,10.948,80350,9.776,2161269,677549,1483720,4.677,14.918,1828498,640418,1188080,4.420,12.621,332771,2.297,25.241,51046,52260,330805
2017,08,118012,147467,2307967,2281279,17071,11.679,14463,9.895,345444,122598,222846,5.374,15.143,291690,107714,183976,4.722,12.786,53754,2.356,25.573,8784,8917,49431
2017,09,63601,81666,1533433,1529771,6368,7.759,7183,8.752,189188,63979,125209,4.182,12.367,181369,74706,106663,4.883,11.856,7819,0.511,23.712,4225,4317,32254
2017,10,17549,22460,395642,396830,2178,9.703,2153,9.591,54638,17847,36791,4.497,13.769,56721,20267,36454,5.107,14.294,-2083,-0.525,27.537,1256,1275,5809
2017,11,16569,21684,528831,524556,1998,9.250,1832,8.481,64115,18790,45325,3.582,12.223,56143,20323,35820,3.874,10.703,7972,1.520,21.406,1009,1022,6702
2017,12,392432,494214,8096805,7989983,58830,11.989,51776,10.552,1190490,389871,800619,4.879,14.900,977523,368536,608987,4.612,12.234,212967,2.665,24.469,32706,33246,185744
2017,13,157642,209340,3856840,3811278,21878,10.528,18802,9.048,552669,185866,366803,4.877,14.501,460493,159598,300895,4.188,12.082,92176,2.419,24.165,11607,11869,70415
2017,15,23014,30100,541450,535223,2539,8.454,2402,7.998,71689,27922,43767,5.217,13.394,59306,16099,43207,3.008,11.081,12383,2.314,22.161,1500,1524,8222
2017,16,34111,41701,578881,571290,4445,10.750,3739,9.043,80454,26357,54097,4.614,14.083,65407,21251,44156,3.720,11.449,15047,2.634,22.898,2261,2296,10804
2017,17,220926,284396,5396149,5399475,25707,9.039,25742,9.051,660962,202303,458659,3.747,12.241,667948,240059,427889,4.446,12.371,-6986,-0.129,24.482,15465,15938,113794
2017,18,98667,136442,2778771,2753916,10886,7.996,10277,7.549,350408,95325,255083,3.461,12.724,301303,91169,210134,3.311,10.941,49105,1.783,21.882,6056,6216,43998
2017,19,55862,74909,1353793,1350682,5664,7.558,5722,7.636,152711,40122,112589,2.970,11.306,147884,42317,105567,3.133,10.949,4827,0.357,21.898,3339,3393,18333
2017,20,52300,69093,1199637,1193433,5621,8.117,5932,8.566,150212,48904,101308,4.098,12.587,137909,46923,90986,3.932,11.556,12303,1.031,23.111,3662,3766,21755
2017,21,61789,85179,1619285,1609069,6913,8.095,7347,8.603,208464,63776,144688,3.964,12.956,189116,67038,122078,4.166,11.753,19348,1.202,23.506,4682,4742,32032
2017,22,73558,98205,1680916,1688118,7917,8.043,8374,8.507,213432,63619,149813,3.769,12.643,227582,69089,158493,4.093,13.481,-14150,-0.838,25.286,4943,5047,31980
2017,23,29147,36486,513025,511168,3072,8.421,3059,8.386,59266,16345,42921,3.198,11.594,55823,18495,37328,3.618,10.921,3443,0.674,21.841,1854,1895,9376
2017,24,97218,126132,2321695,2296590,11178,8.864,11130,8.826,315559,90398,225161,3.936,13.740,266588,88967,177621,3.874,11.608,48971,2.132,23.216,6604,6729,39036
2017,25,126619,161738,3292806,3261422,14215,8.816,13226,8.203,404422,117123,287299,3.591,12.400,340751,112498,228253,3.449,10.448,63671,1.952,20.896,7982,8191,54206
2017,26,153152,200604,3859353,3831865,16306,8.123,16583,8.261,480220,129527,350693,3.380,12.532,426615,142711,283904,3.724,11.133,53605,1.399,22.267,10114,10474,67320
2017,27,102534,134296,2655948,2638549,11519,8.593,11023,8.223,330302,107522,222780,4.075,12.518,296377,93763,202614,3.554,11.233,33925,1.286,22.465,6631,6790,40681
2017,28,40832,55350,935820,934234,4406,7.959,4421,7.986,108105,32179,75926,3.444,11.572,104258,31359,72899,3.357,11.160,3847,0.412,22.319,2742,2816,14970
2017,29,109875,144596,2519314,2504278,14568,10.082,14360,9.938,323783,102046,221737,4.075,12.929,294157,101368,192789,4.048,11.746,29626,1.183,23.492,8882,9087,45754
2017,30,27795,33082,375761,374957,3002,9.089,2894,8.762,49001,14354,34647,3.828,13.068,46950,15560,31390,4.150,12.521,2051,0.547,25.043,1784,1819,8592
2017,31,38790,49838,828401,824162,4111,8.274,3804,7.656,99036,28759,70277,3.489,12.017,90255,31886,58369,3.869,10.951,8781,1.065,21.902,2288,2338,16217
2017,32,45352,58781,1191323,1174865,6879,11.780,6108,10.460,170103,54506,115597,4.639,14.479,138350,52268,86082,4.449,11.776,31753,2.703,23.552,3866,3932,24600
2017,33,27586,34992,603143,598090,2690,7.677,2783,7.943,69786,20560,49226,3.438,11.668,60145,18451,41694,3.085,10.056,9641,1.612,20.112,1695,1727,9404
2017,34,171470,209936,3665423,3634912,20507,9.775,20228,9.642,510491,171206,339285,4.710,14.044,448456,145059,303397,3.991,12.337,62035,1.707,24.675,13068,13270,73030
2017,35,30944,40284,626099,627471,3414,8.459,3565,8.833,76187,24395,51792,3.888,12.142,78536,25504,53032,4.065,12.516,-2349,-0.374,24.284,2162,2215,11150
2017,36,403544,483444,8204580,8159815,48415,10.024,47538,9.842,1077076,333664,743412,4.089,13.200,987837,359301,628536,4.403,12.106,89239,1.094,24.212,32556,32980,186765
2017,37,157390,211695,3753357,3712765,20874,9.944,17325,8.253,489680,154905,334775,4.172,13.189,408755,139802,268953,3.765,11.009,80925,2.180,22.019,10555,10841,63242
2017,38,17504,22227,339617,342553,1830,8.191,2057,9.207,41378,13011,28367,3.798,12.079,47145,14454,32691,4.219,13.763,-5767,-1.684,24.159,1285,1303,6687
2017,39,165455,233243,4807138,4786904,17867,7.615,20610,8.785,600523,178763,421760,3.734,12.545,562308,196324,365984,4.101,11.747,38215,0.798,23.494,10571,10964,83350
2017,40,65408,85765,1356342,1354023,7567,8.807,7878,9.169,175219,58625,116594,4.330,12.941,170816,57179,113637,4.223,12.615,4403,0.325,25.231,4751,4865,29707
2017,41,83732,105489,1592725,1569259,10635,10.156,9083,8.674,219394,63962,155432,4.076,13.981,172508,55479,117029,3.535,10.993,46886,2.988,21.986,5862,5952,28081
2017,42,207435,278739,5416046,5379472,21908,7.848,22708,8.135,655763,188574,467189,3.505,12.190,583085,185521,397564,3.449,10.839,72678,1.351,21.678,13313,13612,75183
2017,44,21552,25940,437396,435803,2093,8.067,2106,8.117,52019,14704,37315,3.374,11.936,49176,15939,33237,3.657,11.284,2843,0.652,22.568,1283,1302,8507
2017,45,74383,99976,1753510,1734793,9316,9.390,7782,7.844,232625,72191,160434,4.161,13.409,195318,66142,129176,3.813,11.259,37307,2.151,22.518,4739,4847,33725
2017,46,19803,24431,359679,358908,1933,7.914,1919,7.857,40864,11539,29325,3.215,11.386,39831,12268,27563,3.418,11.098,1033,0.288,22.196,1155,1170,6518
2017,47,90668,128222,2644961,2624291,11291,8.842,10231,8.012,345046,103384,241662,3.940,13.148,303164,104209,198955,3.971,11.552,41882,1.596,23.104,6183,6369,43842
2017,48,393552,540585,10580025,10500612,57983,10.791,51436,9.573,1582934,539357,1043577,5.136,15.075,1426889,479821,947068,4.569,13.589,156045,1.486,27.177,31339,32433,222925
2017,49,55759,69022,1282118,1261112,8058,11.797,6620,9.692,182415,57550,124865,4.563,14.465,141376,49178,92198,3.900,11.210,41039,3.254,22.421,4006,4077,25728
2017,50,15926,19003,258964,260063,1459,7.662,1536,8.067,28639,7908,20731,3.041,11.012,30540,9006,21534,3.463,11.743,-1901,-0.731,22.025,983,993,4799
2017,51,136793,184361,3308261,3286350,16635,9.043,15835,8.608,420758,120906,299852,3.679,12.803,375865,122756,253109,3.735,11.437,44893,1.366,22.874,9444,9655,54707
2017,53,134096,168801,2682897,2645036,17735,10.581,15343,9.154,374263,102639,271624,3.880,14.150,297384,95037,202347,3.593,11.243,76879,2.907,22.486,9615,9736,50400
2017,54,24537,34123,549564,554545,2500,7.280,2935,8.547,60897,17448,43449,3.146,10.981,71435,20415,51020,3.681,12.882,-10538,-1.900,21.963,1704,1735,8597
2017,55,97441,129821,2545943,2529247,9993,7.694,10110,7.784,302753,87792,214961,3.471,11.970,269772,85001,184771,3.361,10.666,32981,1.304,21.332,6069,6213,36319
2017,56,15553,18544,201850,205051,1796,9.659,1898,10.207,25975,9389,16586,4.579,12.668,32490,10580,21910,5.160,15.845,-6515,-3.177,25.335,1140,1168,4804
2018,01,68246,93681,1720839,1709843,7024,7.490,7227,7.706,208345,59810,148535,3.498,12.185,187981,51064,136917,2.986,10.994,20364,1.191,21.988,4481,4638,26561
2018,02,14056,18083,260844,261487,1653,9.147,1630,9.020,31328,7186,24142,2.748,11.981,32504,8731,23773,3.339,12.430,-1176,-0.450,23.961,927,937,3525
2018,04,95957,128619,2543851,2500226,13574,10.615,12082,9.448,364604,115796,248808,4.631,14.583,275470,91208,184262,3.648,11.018,89134,3.565,22.036,7329,7539,43664
2018,05,45933,61527,1040282,1034225,5080,8.270,4885,7.952,124074,37390,86684,3.615,11.997,111298,32979,78319,3.189,10.761,12776,1.235,21.523,3154,3261,19035
2018,06,661397,834583,14979595,14827737,88231,10.623,80160,9.651,2008211,637074,1371137,4.297,13.544,1705105,564990,1140115,3.810,11.499,303106,2.044,22.999,51878,52991,313546
2018,08,120242,149546,2354613,2331691,16766,11.291,14661,9.873,326253,109919,216334,4.714,13.992,280486,96395,184091,4.134,12.029,45767,1.963,24.059,9099,9264,51202
2018,09,63159,81034,1520482,1526952,6597,8.111,7205,8.858,170996,54178,116818,3.548,11.199,183961,64078,119883,4.196,12.048,-12965,-0.849,22.397,4314,4363,27373
2018,10,17775,22661,403078,399949,2195,9.733,1979,8.775,51898,16690,35208,4.173,12.976,45917,13659,32258,3.415,11.481,5981,1.495,22.961,1205,1218,6647
2018,11,16795,21794,542065,535310,2025,9.316,1909,8.783,65371,21051,44320,3.932,12.212,51539,16350,35189,3.054,9.628,13832,2.584,19.256,1010,1023,7019
2018,12,399390,500281,8301116,8187086,58102,11.686,51915,10.442,1158402,411959,746443,5.032,14.149,928934,346574,582360,4.233,11.346,229468,2.803,22.693,33024,33648,173357
2018,13,159736,211034,3953214,3911113,21330,10.150,19567,9.311,543789,171010,372779,4.372,13.904,458349,152270,306079,3.893,11.719,85440,2.185,23.438,12088,12399,72459
2018,15,23159,30269,550240,546472,2519,8.346,2343,7.763,62088,19875,42213,3.637,11.362,54016,15972,38044,2.923,9.884,8072,1.477,19.769,1462,1501,9512
2018,16,35359,43127,598294,588461,4935,11.638,3492,8.235,85263,28769,56494,4.889,14.489,65226,19893,45333,3.381,11.084,20037,3.405,22.168,2213,2270,11051
2018,17,220582,283541,5437357,5420816,24119,8.494,24912,8.774,646464,194345,452119,3.585,11.926,611702,179952,431750,3.320,11.284,34762,0.641,22.569,15308,15643,83577
2018,18,99077,136705,2813941,2797641,10814,7.919,10512,7.698,342698,96877,245821,3.463,12.250,310549,101678,208871,3.634,11.100,32149,1.149,22.201,6292,6541,49756
2018,19,56278,75425,1368137,1360951,5807,7.727,5266,7.007,145419,38892,106527,2.858,10.685,130993,35942,95051,2.641,9.625,14426,1.060,19.250,3234,3364,19240
2018,20,52070,68714,1200460,1200524,5294,7.688,5584,8.109,138734,40684,98050,3.389,11.556,138876,39879,98997,3.322,11.568,-142,-0.012,23.112,3545,3636,20094
2018,21,60781,84070,1635201,1627157,6385,7.578,6765,8.029,193200,59130,134070,3.634,11.873,176318,54205,122113,3.331,10.836,16882,1.038,21.672,4229,4350,28006
2018,22,73602,97922,1685483,1684672,7947,8.105,8198,8.361,202933,59280,143653,3.519,12.046,201527,60237,141290,3.576,11.962,1406,0.083,23.925,5016,5214,32337
2018,23,29334,36521,516050,514461,2917,7.992,2869,7.861,56827,15063,41764,2.928,11.046,53642,16291,37351,3.167,10.427,3185,0.619,20.854,1771,1807,8625
2018,24,97538,126278,2353103,2337009,10998,8.716,10817,8.572,286124,84187,201937,3.602,12.243,253340,76363,176977,3.268,10.840,32784,1.403,21.681,6513,6643,37516
2018,25,127075,161917,3334056,3308906,13562,8.382,13329,8.238,402170,122696,279474,3.708,12.154,349478,110141,239337,3.329,10.562,52692,1.592,21.123,8145,8289,48158
2018,26,153477,200934,3919125,3883114,16367,8.155,15904,7.924,486540,127539,359001,3.284,12.530,410869,132911,277958,3.423,10.581,75671,1.949,21.162,10032,10280,67857
2018,27,102100,133661,2696120,2675864,10621,7.929,11187,8.352,314997,81987,233010,3.064,11.772,274427,90918,183509,3.398,10.256,40570,1.516,20.511,6779,6956,47228
2018,28,40797,55331,942952,941424,4249,7.678,4274,7.723,104404,30610,73794,3.251,11.090,101535,28921,72614,3.072,10.785,2869,0.305,21.571,2682,2780,15165
2018,29,104019,138555,2522461,2518751,13389,9.663,13400,9.671,298286,89811,208475,3.566,11.843,290175,90218,199957,3.582,11.521,8111,0.322,23.041,8661,8809,43118
2018,30,28105,33418,370071,372910,3222,9.691,2884,8.674,45188,15780,29408,4.232,12.118,51977,13839,38138,3.711,13.938,-6789,-1.821,24.235,1803,1822,7751
2018,31,38710,49677,841185,834975,3830,7.698,3987,8.013,99879,30153,69726,3.611,11.962,87480,29986,57494,3.591,10.477,12399,1.485,20.954,2418,2471,13353
2018,32,46563,60043,1219417,1205605,7284,12.262,6000,10.101,166821,60730,106091,5.037,13.837,139379,46401,92978,3.849,11.561,27442,2.276,23.122,3771,3859,23392
2018,33,27692,35087,613074,607947,2802,7.999,2691,7.682,72001,24641,47360,4.053,11.843,61940,18460,43480,3.036,10.188,10061,1.655,20.377,1752,1766,9924
2018,34,171446,209543,3722141,3698578,19346,9.225,19688,9.388,476711,147171,329540,3.979,12.889,429596,135006,294590,3.650,11.615,47115,1.274,23.230,12885,12984,65012
2018,35,30878,40071,629883,628062,3341,8.317,3540,8.812,73956,24822,49134,3.952,11.775,70107,22322,47785,3.554,11.162,3849,0.613,22.325,2140,2177,10502
2018,36,403743,482906,8317277,8264851,47032,9.736,47394,9.811,1035305,316285,719020,3.827,12.527,930609,314788,615821,3.809,11.260,104696,1.267,22.520,32569,32960,179569
2018,37,159822,213947,3850074,3813241,20294,9.537,17999,8.458,491533,155895,335638,4.088,12.890,418610,142866,275744,3.747,10.978,72923,1.912,21.956,10984,11317,69182
2018,38,17411,22132,343675,341664,1748,7.882,1836,8.279,42664,11954,30710,3.499,12.487,38885,12108,26777,3.544,11.381,3779,1.106,22.762,1146,1197,6350
2018,39,164861,232055,4863157,4835220,16898,7.265,17997,7.737,575803,157141,418662,3.250,11.909,520260,159860,360400,3.306,10.760,55543,1.149,21.520,10425,10725,67639
2018,40,65459,85636,1379872,1368645,7403,8.640,7493,8.745,183187,54504,128683,3.982,13.385,161086,53216,107870,3.888,11.770,22101,1.615,23.539,4709,4819,26067
2018,41,85154,106864,1623623,1608735,10537,9.926,9124,8.595,201597,57572,144025,3.579,12.531,172853,57234,115619,3.558,10.745,28744,1.787,21.489,5924,6015,31078
2018,42,207343,279267,5471138,5446652,21914,7.857,21228,7.611,608777,166466,442311,3.056,11.177,559027,172042,386985,3.159,10.264,49750,0.913,20.527,12886,13101,74462
2018,44,21512,25780,442189,439560,2146,8.308,2250,8.710,54402,14938,39464,3.398,12.376,48625,17897,30728,4.072,11.062,5777,1.314,22.124,1324,1360,7616
2018,45,75658,101156,1806109,1784937,9403,9.350,8219,8.173,243689,73713,169976,4.130,13.653,201475,65797,135678,3.686,11.288,42214,2.365,22.575,4938,5087,28552
2018,46,19883,24512,359341,359750,2026,8.282,1928,7.881,36882,10944,25938,3.042,10.252,37567,12497,25070,3.474,10.443,-685,-0.190,20.504,1219,1249,6641
2018,47,91351,128831,2668601,2653957,10787,8.394,10143,7.893,312261,92361,219900,3.480,11.766,283120,85661,197459,3.228,10.668,29141,1.098,21.336,6169,6425,41592
2018,48,399487,546695,10800658,10692932,56584,10.410,50261,9.247,1500815,493956,1006859,4.619,14.036,1285682,414364,871318,3.875,12.024,215133,2.012,24.047,31489,32332,214033
2018,49,57464,70686,1337872,1310692,8263,11.830,6583,9.425,188388,59058,129330,4.506,14.373,134372,50068,84304,3.820,10.252,54016,4.121,20.504,4002,4061,27846
2018,50,15850,18903,262181,260505,1376,7.262,1465,7.732,27696,8733,18963,3.352,10.632,24542,8201,16341,3.148,9.421,3154,1.211,18.842,936,947,4884
2018,51,137321,184606,3385963,3348072,16263,8.817,15957,8.651,426095,124906,301189,3.731,12.727,350987,107693,243294,3.217,10.483,75108,2.243,20.967,9513,9731,53272
2018,53,136529,171209,2761656,2723828,17901,10.530,15477,9.104,371285,117176,254109,4.302,13.631,295845,98445,197400,3.614,10.861,75440,2.770,21.723,9892,10121,52010
2018,54,24131,33666,557964,553750,2303,6.796,2748,8.109,69103,20799,48304,3.756,12.479,60921,19657,41264,3.550,11.002,8182,1.478,22.003,1695,1736,9906
2018,55,97541,129621,2597539,2577737,9626,7.423,9736,7.508,290322,79514,210808,3.085,11.263,251418,77053,174365,2.989,9.753,38904,1.509,19.507,5931,6117,33682
2018,56,15738,18661,208618,206355,1907,10.253,1785,9.597,28959,9648,19311,4.675,14.034,24374,8868,15506,4.297,11.812,4585,2.222,23.623,1132,1166,5158
2019,01,68736,94633,1762162,1742032,7701,8.178,6759,7.178,204715,60769,143946,3.488,11.752,165544,48974,116570,2.811,9.503,39171,2.249,19.006,4508,4631,26468
2019,02,14113,18125,263816,262556,1651,9.133,1557,8.613,30563,8429,22134,3.210,11.641,27992,7290,20702,2.777,10.661,2571,0.979,21.323,943,958,3665
2019,04,97589,130700,2613449,2579591,13793,10.638,11718,9.037,356117,120786,235331,4.682,13.805,288215,99615,188600,3.862,11.173,67902,2.632,22.346,7427,7561,51229
2019,05,46188,62092,1054428,1047242,5418,8.765,4866,7.872,120700,41878,78822,3.999,11.526,107227,35082,72145,3.350,10.239,13473,1.287,20.478,3210,3354,21509
2019,06,672173,847440,15304450,15136445,92321,10.978,79403,9.442,2027006,675823,1351183,4.465,13.392,1692197,562059,1130138,3.713,11.180,334809,2.212,22.359,53587,54413,304639
2019,08,121912,151833,2412233,2383207,17322,11.496,15021,9.969,328829,114640,214189,4.810,13.798,269318,93193,176125,3.910,11.301,59511,2.497,22.601,9839,9928,54329
2019,09,63081,81322,1542676,1531635,6664,8.209,6383,7.863,164869,48623,116246,3.175,10.764,142586,44623,97963,2.913,9.309,22283,1.455,18.619,4306,4357,24003
2019,10,18082,23027,414629,408954,2224,9.734,1865,8.163,54472,15292,39180,3.739,13.320,42643,16564,26079,4.050,10.427,11829,2.893,20.855,1220,1233,6203
2019,11,16918,22010,532976,537483,2006,9.159,1790,8.173,55712,19819,35893,3.687,10.365,65314,19815,45499,3.687,12.152,-9602,-1.786,20.731,1085,1099,8815
2019,12,407354,510357,8444899,8359804,61154,12.102,51070,10.107,1077687,391011,686676,4.677,12.891,910303,320979,589324,3.840,10.889,167384,2.002,21.778,34712,35136,179005
2019,13,162157,214732,4035351,3995391,22407,10.525,18747,8.805,533263,178459,354804,4.467,13.347,453883,154178,299705,3.859,11.360,79380,1.987,22.720,12358,12539,71880
2019,15,23326,30496,553171,551750,2567,8.449,2341,7.705,55375,19820,35555,3.592,10.036,52569,18213,34356,3.301,9.528,2806,0.509,19.055,1553,1580,10314
2019,16,36699,44622,618190,607827,5162,11.764,3675,8.375,78253,29083,49170,4.785,12.874,57584,17076,40508,2.809,9.474,20669,3.400,18.947,2396,2429,10078
2019,17,220416,284223,5478394,5457765,24843,8.751,24188,8.520,602904,184629,418275,3.383,11.047,563138,172489,390649,3.160,10.318,39766,0.729,20.636,15900,16172,91239
2019,18,99194,137875,2835824,2825091,10804,7.869,9654,7.031,283275,81506,201769,2.885,10.027,260360,69322,191038,2.454,9.216,22915,0.811,18.432,6431,6591,38634
2019,19,56154,75525,1387949,1376629,5511,7.301,5426,7.188,143216,35929,107287,2.610,10.403,120704,35176,85528,2.555,8.768,22512,1.635,17.536,3560,3641,20568
2019,20,51867,68750,1211242,1205078,5454,7.935,5414,7.877,133880,40540,93340,3.364,11.110,121615,38012,83603,3.154,10.092,12265,1.018,20.184,3562,3686,20890
2019,21,61101,84684,1667087,1651539,6851,8.121,6205,7.355,191211,58980,132231,3.571,11.578,160216,49345,110871,2.988,9.701,30995,1.877,19.402,4040,4160,24370
2019,22,73814,98395,1715942,1700778,8151,8.304,7683,7.827,204716,69961,134755,4.113,12.037,174503,53027,121476,3.118,10.260,30213,1.776,20.520,5187,5282,33685
2019,23,29529,36876,522289,519153,3173,8.647,2809,7.655,56582,15042,41540,2.897,10.899,50138,15533,34605,2.992,9.658,6444,1.241,19.315,1857,1879,8426
2019,24,98013,127000,2372268,2363099,10936,8.636,10216,8.067,258724,79685,179039,3.372,10.949,240074,75321,164753,3.187,10.159,18650,0.789,20.319,6627,6756,39093
2019,25,128122,163624,3383188,3348016,14185,8.715,12481,7.668,369136,102177,266959,3.052,11.026,299454,94698,204756,2.828,8.944,69682,2.081,17.888,8270,8407,46641
2019,26,153178,201266,3922304,3904614,16137,8.027,15694,7.806,419651,112441,307210,2.880,10.748,384499,105049,279450,2.690,9.847,35152,0.900,19.695,10557,10675,61096
2019,27,102019,134030,2696221,2695390,10757,8.037,10399,7.769,276654,82893,193761,3.075,10.264,274781,78312,196469,2.905,10.194,1873,0.069,20.389,6736,6889,41388
2019,28,40790,55497,956885,949899,4218,7.611,4065,7.335,103226,31810,71416,3.349,10.867,89494,25754,63740,2.711,9.421,13732,1.446,18.843,2778,2817,14532
2019,29,104315,139141,2542810,2532330,13356,9.640,12170,8.784,277004,84896,192108,3.352,10.939,257353,82529,174824,3.259,10.163,19651,0.776,20.325,8035,8154,40242
2019,30,28394,33813,375345,373401,3259,9.695,2863,8.517,42566,14229,28337,3.811,11.400,38802,12344,26458,3.306,10.392,3764,1.008,20.783,1881,1895,8071
2019,31,38739,49878,854272,848482,3865,7.764,3672,7.376,92652,29330,63322,3.457,10.920,81079,21633,59446,2.550,9.556,11573,1.364,19.112,2376,2406,11938
2019,32,47421,61110,1262679,1241507,7128,11.768,6050,9.988,171344,55608,115736,4.479,13.801,129065,46674,82391,3.759,10.396,42279,3.405,20.792,4117,4192,28870
2019,33,27927,35431,620404,616592,2909,8.251,2561,7.264,62110,18127,43983,2.940,10.073,55222,16033,39189,2.600,8.956,6888,1.117,17.912,1744,1750,8605
2019,34,172394,211184,3794755,3758815,20478,9.734,18853,8.962,462714,149963,312751,3.990,12.310,392412,129464,262948,3.444,10.440,70302,1.870,20.880,13010,13175,72000
2019,35,31046,40342,636262,633278,3525,8.768,3251,8.086,73566,24569,48997,3.880,11.617,68308,18949,49359,2.992,10.786,5258,0.830,21.573,2193,2218,11122
2019,36,404870,485542,8468293,8384186,47541,9.818,44929,9.278,1035597,330821,704776,3.946,12.352,870642,289471,581171,3.453,10.384,164955,1.967,20.769,32638,33025,178199
2019,37,162204,217222,3942385,3895433,20247,9.392,16971,7.872,489815,150441,339374,3.862,12.574,399724,141663,258061,3.637,10.261,90091,2.313,20.523,11106,11266,65200
2019,38,17526,22374,350783,347355,1829,8.219,1586,7.127,37033,11745,25288,3.381,10.661,30292,8615,21677,2.480,8.721,6741,1.941,17.442,1062,1087,5724
2019,39,164973,232076,4905469,4876800,17487,7.535,17487,7.535,536145,154726,381419,3.173,10.994,479957,152864,327093,3.135,9.842,56188,1.152,19.683,10639,10881,70997
2019,40,65827,86145,1401318,1390999,7753,9.027,7245,8.435,170861,54648,116213,3.929,12.283,151139,43715,107424,3.143,10.866,19722,1.418,21.731,4785,4958,26964
2019,41,85701,107743,1644461,1634100,10287,9.587,9401,8.761,195097,60847,134250,3.724,11.939,174657,53420,121237,3.269,10.688,20440,1.251,21.377,6329,6402,30418
2019,42,208529,280111,5556376,5514130,21888,7.826,21037,7.522,590332,169111,421221,3.067,10.706,507797,162104,345693,2.940,9.209,82535,1.497,18.418,12960,13313,80344
2019,44,21647,25985,439541,440810,2284,8.826,2073,8.010,42424,14183,28241,3.217,9.624,45297,13675,31622,3.102,10.276,-2873,-0.652,19.248,1367,1373,7820
2019,45,76776,102819,1844220,1823781,9658,9.469,8008,7.851,235970,75681,160289,4.150,12.939,195840,63263,132577,3.469,10.738,40130,2.200,21.476,5225,5324,32015
2019,46,19949,24633,359788,359543,2011,8.184,1888,7.684,33820,10948,22872,3.045,9.406,33656,9232,24424,2.568,9.361,164,0.046,18.722,1248,1266,5784
2019,47,92103,130643,2726721,2703061,11676,9.000,9870,7.608,320501,108134,212367,4.000,11.857,272687,83660,189027,3.095,10.088,47814,1.769,20.176,6444,6568,38845
2019,48,407546,557547,11109140,10954065,58934,10.674,48121,8.715,1488314,498615,989699,4.552,13.587,1186179,387553,798626,3.538,10.829,302135,2.758,21.657,32069,32864,210155
2019,49,59035,72407,1375209,1356262,8441,11.797,6736,9.414,173543,56102,117441,4.137,12.796,135890,43351,92539,3.196,10.019,37653,2.776,20.039,4463,4524,27169
2019,50,15739,18825,261794,262207,1406,7.453,1485,7.872,23905,7512,16393,2.865,9.117,25039,7791,17248,2.971,9.549,-1134,-0.432,18.234,1020,1028,4581
2019,51,138709,186851,3465655,3427946,16861,9.078,14627,7.875,411658,122544,289114,3.575,12.009,337398,102903,234495,3.002,9.843,74260,2.166,19.685,9650,9786,57826
2019,53,137952,173259,2820597,2791105,17727,10.292,15682,9.105,347593,112253,235340,4.022,12.454,289060,95391,193669,3.418,10.356,58533,2.097,20.713,10478,10639,53438
2019,54,24055,33708,556130,557303,2504,7.434,2454,7.286,59068,19985,39083,3.586,10.599,61546,20800,40746,3.732,11.044,-2478,-0.445,21.198,1605,1628,10987
2019,55,97506,130309,2604597,2600258,9909,7.624,9230,7.102,275533,90821,184712,3.493,10.596,267248,72061,195187,2.771,10.278,8285,0.319,20.555,6063,6201,41304
2019,56,15867,18834,210560,209751,1891,10.088,1713,9.138,23644,8068,15576,3.846,11.272,22071,6970,15101,3.323,10.522,1573,0.750,21.045,1166,1177,4546
2020,01,68371,94546,1781932,1772325,7307,7.725,7395,7.818,203807,54442,149365,3.072,11.499,184549,51814,132735,2.924,10.413,19258,1.087,20.826,4636,4773,27018
2020,02,14106,18107,263827,263764,1653,9.126,1666,9.198,29693,7576,22117,2.872,11.257,29913,8173,21740,3.099,11.341,-220,-0.083,22.515,976,1001,5084
2020,04,98832,132339,2644141,2632985,14122,10.737,12492,9.498,328184,110012,218172,4.178,12.464,306008,92191,213817,3.501,11.622,22176,0.842,23.244,7732,7882,47619
2020,05,46088,62278,1055133,1055905,5275,8.482,5093,8.190,115909,37036,78873,3.508,10.977,117021,34207,82814,3.240,11.083,-1112,-0.105,21.954,3275,3322,20194
2020,06,685122,862365,15375464,15310791,99289,11.614,84334,9.865,2044401,757685,1286716,4.949,13.353,1909670,626621,1283049,4.093,12.473,134731,0.880,24.945,55829,56938,337617
2020,08,122309,152700,2438775,2426895,17193,11.291,16333,10.726,330634,111219,219415,4.583,13.624,307301,101484,205817,4.182,12.662,23333,0.961,25.325,9995,10143,55797
2020,09,62457,80843,1548717,1545413,6806,8.394,7284,8.983,190679,77625,113054,5.023,12.338,185212,58408,126804,3.779,11.985,5467,0.354,23.969,4533,4617,27216
2020,10,18959,23952,419080,416919,2983,12.700,2056,8.753,52806,21474,31332,5.151,12.666,48631,18923,29708,4.539,11.664,4175,1.001,23.329,1293,1304,7863
2020,11,16904,22056,544609,539004,2037,9.245,1993,9.045,66075,22236,43839,4.125,12.259,55462,17384,38078,3.225,10.290,10613,1.969,20.579,1135,1148,8302
2020,12,411656,517242,8587626,8509768,62706,12.204,55817,10.864,1156743,426226,730517,5.009,13.593,1002232,358475,643757,4.213,11.777,154511,1.816,23.555,35480,35946,180746
2020,13,163651,216971,4107742,4073237,22720,10.526,20478,9.487,528084,193239,334845,4.744,12.965,460369,141503,318866,3.474,11.302,67715,1.662,22.605,12781,13024,69296
2020,15,23022,30206,548369,550748,2368,7.802,2660,8.764,49546,14005,35541,2.543,8.996,54375,16507,37868,2.997,9.873,-4829,-0.877,17.992,1704,1733,8585
2020,16,37605,45761,640032,629220,5284,11.692,4149,9.181,82857,30903,51954,4.911,13.168,61489,19508,41981,3.100,9.772,21368,3.396,19.545,2602,2635,11364
2020,17,218378,282251,5494443,5492494,24663,8.708,26635,9.404,616368,191542,424826,3.487,11.222,613480,198542,414938,3.615,11.169,2888,0.053,22.339,16030,16358,92861
2020,18,98704,137385,2825420,2830528,10980,7.977,11491,8.349,298879,87296,211583,3.084,10.559,309584,98662,210922,3.486,10.937,-10705,-0.378,21.118,6618,6816,44241
2020,19,55939,75515,1393415,1390351,5762,7.630,5766,7.635,136436,40764,95672,2.932,9.813,130520,36444,94076,2.621,9.388,5916,0.426,18.775,3518,3598,18371
2020,20,51415,68399,1205466,1209187,5358,7.814,5699,8.311,131554,39622,91932,3.277,10.880,139651,43964,95687,3.636,11.549,-8097,-0.670,21.759,3529,3598,22453
2020,21,60433,84364,1663074,1665934,6499,7.689,6813,8.061,176378,54873,121505,3.294,10.587,183417,58934,124483,3.538,11.010,-7039,-0.423,21.175,4214,4333,27785
2020,22,73168,98019,1702056,1708675,7860,8.003,8237,8.387,188281,57135,131146,3.344,11.019,201627,58420,143207,3.419,11.800,-13346,-0.781,22.038,5037,5136,29056
2020,23,29565,36983,521797,522013,3137,8.496,3017,8.171,53025,15917,37108,3.049,10.158,53237,15398,37839,2.950,10.198,-212,-0.041,20.316,1916,1948,9547
2020,24,97573,126825,2400413,2385877,11115,8.758,11289,8.895,282887,85321,197566,3.576,11.857,253353,79031,174322,3.312,10.619,29534,1.238,21.238,6823,6942,39379
2020,25,127975,163711,3390729,3386605,14115,8.624,14033,8.574,360833,112587,248246,3.324,10.655,350377,106792,243585,3.153,10.346,10456,0.309,20.692,8794,8968,54304
2020,26,151711,200162,3957625,3951556,16521,8.232,17591,8.765,435265,142582,292683,3.608,11.015,421842,128071,293771,3.241,10.675,13423,0.340,21.351,10562,10752,68919
2020,27,101637,133900,2706495,2701985,11049,8.248,11184,8.348,278637,78046,200591,2.888,10.312,268085,80806,187279,2.991,9.922,10552,0.391,19.844,6836,7057,40882
2020,28,40403,55188,951196,953950,4216,7.618,4523,8.173,98258,29770,68488,3.121,10.300,103758,32057,71701,3.360,10.877,-5500,-0.577,20.600,2788,2814,15696
2020,29,103169,138185,2563439,2552507,12675,9.172,12692,9.184,285024,103569,181455,4.058,11.166,264303,79910,184393,3.131,10.355,20721,0.812,20.709,8109,8305,40230
2020,30,28744,34299,378664,377149,3589,10.539,3097,9.095,45009,15912,29097,4.219,11.934,41754,15235,26519,4.040,11.071,3255,0.863,22.142,1905,1929,9047
2020,31,38700,49855,864204,859441,3991,8.004,4011,8.044,94535,26379,68156,3.069,11.000,85139,28022,57117,3.260,9.906,9396,1.093,19.813,2404,2475,13366
2020,32,48276,62315,1276693,1268923,7309,11.842,6116,9.910,164068,59458,104610,4.686,12.930,149250,54994,94256,4.334,11.762,14818,1.168,23.524,3882,3947,25883
2020,33,27860,35350,620449,620554,2745,7.756,2832,8.001,58515,15986,42529,2.576,9.429,58541,18373,40168,2.961,9.434,-26,-0.004,18.859,1841,1875,10151
2020,34,171064,210523,3794228,3794273,19983,9.477,20638,9.788,445738,151589,294149,3.995,11.748,444543,148233,296310,3.907,11.716,1195,0.031,23.432,13298,13541,73909
2020,35,30791,40238,652036,649218,3518,8.732,3621,8.987,77142,27252,49890,4.198,11.882,71322,22787,48535,3.510,10.986,5820,0.896,21.972,2253,2342,12001
2020,36,397641,478394,8474071,8480346,45774,9.497,52937,10.983,971734,297640,674094,3.510,11.459,983441,328297,655144,3.871,11.597,-11707,-0.138,22.917,34281,34726,179071
2020,37,163706,219148,3976335,3961312,20721,9.497,18787,8.611,456448,152453,303995,3.849,11.523,424732,133214,291518,3.363,10.722,31716,0.801,21.444,11530,11845,67285
2020,38,17505,22383,353047,351972,1813,8.102,1799,8.040,38516,12956,25560,3.681,10.943,36689,11012,25677,3.129,10.424,1827,0.519,20.848,1115,1130,5831
2020,39,163514,230147,4928473,4925182,17152,7.421,19086,8.258,544846,172380,372466,3.500,11.062,539963,164435,375528,3.339,10.963,4883,0.099,21.927,10910,11248,75494
2020,40,65331,85813,1403100,1402174,7789,9.059,8121,9.445,172596,62355,110241,4.447,12.309,169959,50320,119639,3.589,12.121,2637,0.188,24.242,5122,5206,26572
2020,41,85853,108077,1657565,1650825,10282,9.528,9944,9.215,190343,61018,129325,3.696,11.530,176871,55265,121606,3.348,10.714,13472,0.816,21.428,6445,6550,31428
2020,42,207745,279866,5531813,5528262,21620,7.722,21870,7.811,577755,182351,395404,3.299,10.451,571510,165872,405638,3.000,10.338,6245,0.113,20.676,13407,13785,85717
2020,44,21607,25985,445477,442436,2182,8.398,2179,8.386,48958,15830,33128,3.578,11.066,42882,13516,29366,3.055,9.692,6076,1.373,19.385,1423,1428,6572
2020,45,77253,103646,1857489,1852373,9583,9.280,8819,8.540,219369,75221,144148,4.061,11.843,209697,62695,147002,3.385,11.320,9672,0.522,22.641,5400,5599,31024
2020,46,20029,24820,365983,363039,2162,8.744,1971,7.972,41400,14652,26748,4.036,11.404,35769,11773,23996,3.243,9.853,5631,1.551,19.705,1227,1287,7438
2020,47,92487,131348,2767468,2747452,11557,8.822,10852,8.284,336599,109826,226773,3.997,12.251,296049,92296,203753,3.359,10.775,40550,1.476,21.551,6644,6815,43189
2020,48,411932,563594,11225437,11173719,58946,10.516,52882,9.434,1486323,546715,939608,4.893,13.302,1383581,430847,952734,3.856,12.382,102742,0.919,24.765,33310,34114,217697
2020,49,60297,73956,1406774,1391742,8893,12.152,7342,10.033,187598,55983,131615,4.023,13.479,158441,53122,105319,3.817,11.384,29157,2.095,22.769,4547,4619,32279
2020,50,15561,18644,257709,259582,1413,7.543,1592,8.498,24244,6908,17336,2.661,9.340,27876,9141,18735,3.521,10.739,-3632,-1.399,18.679,1009,1016,5397
2020,51,138570,186790,3486537,3476335,16388,8.772,16466,8.813,408007,124174,283833,3.572,11.737,387915,123219,264696,3.545,11.159,20092,0.578,22.317,9950,10164,55272
2020,53,137435,173364,2872215,2847650,17543,10.122,17450,10.068,357630,122947,234683,4.317,12.559,306706,101748,204958,3.573,10.770,50924,1.788,21.541,11028,11184,52997
2020,54,23449,33187,545756,551152,2279,6.814,2800,8.371,52517,17214,35303,3.123,9.529,63535,18553,44982,3.366,11.528,-11018,-1.999,19.057,1679,1729,8475
2020,55,97028,130038,2598806,2601429,9727,7.473,9984,7.670,269597,75459,194138,2.901,10.363,273762,82476,191286,3.170,10.524,-4165,-0.160,20.727,6092,6275,38154
2020,56,16054,19020,209518,209496,2087,11.027,1901,10.044,25216,10115,15101,4.828,12.037,25059,9862,15197,4.707,11.962,157,0.075,23.923,1228,1259,4802
2021,01,69639,95883,1723274,1753357,8972,9.423,7634,8.018,181806,60808,120998,3.468,10.369,241945,52486,189459,2.993,13.799,-60139,-3.430,20.738,4401,4697,24196
2021,02,14451,18396,251083,257693,1976,10.826,1689,9.254,28388,7944,20444,3.083,11.016,41291,9112,32179,3.536,16.023,-12903,-5.007,22.032,966,985,3503
2021,04,102450,136006,2619195,2631704,16673,12.427,13003,9.691,360671,126122,234549,4.792,13.705,383727,100292,283435,3.811,14.581,-23056,-0.876,27.410,7878,8092,48550
2021,05,46777,62980,1039744,1048243,6016,9.606,5308,8.476,123658,35512,88146,3.388,11.797,140121,34109,106012,3.254,13.367,-16463,-1.571,23.593,3156,3405,16368
2021,06,683804,859303,14520665,14944546,101876,11.835,104859,12.182,1891703,650939,1240764,4.356,12.658,2736302,684679,2051623,4.581,18.310,-844599,-5.652,25.316,60939,62260,334939
2021,08,125816,156075,2353200,2396617,19704,12.763,16320,10.571,321655,116790,204865,4.873,13.421,408149,108697,299452,4.535,17.030,-86494,-3.609,26.842,9935,10163,54297
2021,09,62037,80191,1445902,1497467,7391,9.180,8041,9.987,141129,51867,89262,3.464,9.425,243489,53686,189803,3.585,16.260,-102360,-6.836,18.849,4549,4721,27443
2021,10,19621,24492,412181,415936,2883,11.903,2341,9.665,57478,21042,36436,5.059,13.819,64962,18203,46759,4.376,15.618,-7484,-1.799,27.638,1383,1427,8417
2021,11,16841,21792,488960,516820,2281,10.406,2536,11.570,52559,20309,32250,3.930,10.170,108306,23169,85137,4.483,20.956,-55747,-10.787,20.339,1213,1253,9721
2021,12,432492,538605,8409699,8512968,76993,14.584,55619,10.536,1095977,449737,646240,5.283,12.874,1300930,320778,980152,3.768,15.282,-204953,-2.408,25.748,34639,35366,159235
2021,13,171781,224588,4045668,4078651,28966,13.120,21352,9.671,536767,200812,335955,4.923,13.160,604629,168125,436504,4.122,14.824,-67862,-1.664,26.321,12254,12698,69054
2021,15,22130,29150,470180,509233,2558,8.618,3619,12.193,37918,14389,23529,2.826,7.446,115967,22330,93637,4.385,22.773,-78049,-15.327,14.892,1955,2026,11096
2021,16,39362,47672,652934,646611,6004,12.852,4096,8.767,89379,29608,59771,4.579,13.823,76486,23447,53039,3.626,11.829,12893,1.994,23.658,2527,2594,13492
2021,17,218884,282122,5239781,5366928,28306,10.031,28429,10.075,567400,179352,388048,3.342,10.572,820283,189723,630560,3.535,15.284,-252883,-4.712,21.144,16055,16456,86530
2021,18,99916,138547,2761846,2794123,12546,9.094,11365,8.238,311061,95573,215488,3.421,11.133,374081,92545,281536,3.312,13.388,-63020,-2.255,22.265,6456,6700,39057
2021,19,56287,75661,1352086,1373195,6336,8.382,6195,8.195,126798,39008,87790,2.841,9.234,168234,40537,127697,2.952,12.251,-41436,-3.017,18.468,3443,3550,16261
2021,20,52077,69048,1199248,1203136,6172,8.981,5524,8.038,147704,41160,106544,3.421,12.277,156868,36071,120797,2.998,13.038,-9164,-0.762,24.553,3272,3412,18055
2021,21,60398,84684,1618232,1641505,7702,9.113,7364,8.713,182537,63251,119286,3.853,11.120,229225,60968,168257,3.714,13.964,-46688,-2.844,22.240,4116,4333,25224
2021,22,73917,98532,1595071,1648773,9187,9.349,8664,8.816,167121,59783,107338,3.626,10.136,273503,58369,215134,3.540,16.588,-106382,-6.452,20.272,5043,5306,28724
2021,23,29881,37327,505935,513936,3647,9.818,3284,8.841,59743,24600,35143,4.787,11.625,75370,19384,55986,3.772,14.665,-15627,-3.041,23.249,1998,2029,9391
2021,24,98103,126713,2279648,2336577,12665,9.991,12777,10.079,263659,79992,183667,3.423,11.284,376417,93949,282468,4.021,16.110,-112758,-4.826,22.568,7008,7269,42563
2021,25,125892,160693,3177636,3284746,14520,8.952,17531,10.808,316577,95855,220722,2.918,9.638,532613,125679,406934,3.826,16.215,-216036,-6.577,19.276,9544,9833,54640
2021,26,150656,200484,3749670,3853067,20313,10.141,19972,9.970,393777,135723,258054,3.522,10.220,598605,138271,460334,3.589,15.536,-204828,-5.316,20.440,10859,11325,63708
2021,27,102744,134966,2591045,2649699,12412,9.233,11339,8.435,272184,77494,194690,2.925,10.272,387798,85023,302775,3.209,14.636,-115614,-4.363,20.545,6641,6840,37564
2021,28,40955,55548,932274,941637,5031,9.087,4667,8.429,101338,32113,69225,3.410,10.762,120670,28924,91746,3.072,12.815,-19332,-2.053,21.524,2688,3021,13689
2021,29,104163,138942,2468568,2513682,13716,9.911,12624,9.122,271974,88373,183601,3.516,10.820,362460,90733,271727,3.610,14.419,-90486,-3.600,21.639,7742,7979,43421
2021,30,29594,35204,380843,380313,3930,11.309,3027,8.710,47413,15930,31483,4.189,12.467,46318,13772,32546,3.621,12.179,1095,0.288,24.358,1927,1963,8324
2021,31,39533,50509,850758,857640,4486,8.939,3834,7.640,91829,29168,62661,3.401,10.707,105607,30699,74908,3.579,12.314,-13778,-1.607,21.414,2162,2223,12834
2021,32,50104,64306,1165697,1221519,8670,13.694,6684,10.557,156267,57086,99181,4.673,12.793,268100,46681,221419,3.822,21.948,-111833,-9.155,25.586,3985,4066,23718
2021,33,27883,35269,586052,603079,3120,8.837,3197,9.055,57608,18952,38656,3.143,9.552,91310,20970,70340,3.477,15.141,-33702,-5.588,19.105,1855,1929,11394
2021,34,168318,206942,3565823,3687210,21415,10.260,24989,11.972,408048,145450,262598,3.945,11.067,650650,162892,487758,4.418,17.646,-242602,-6.580,22.133,14270,14728,76522
2021,35,30460,39829,606502,629295,3748,9.363,4150,10.367,62757,23396,39361,3.718,9.973,108064,27788,80276,4.416,17.172,-45307,-7.200,19.945,2287,2376,11315
2021,36,385880,465225,7732961,8104031,48498,10.279,61640,13.065,829022,320850,508172,3.959,10.230,1571954,374341,1197613,4.619,19.397,-742932,-9.167,20.459,36157,36929,189985
2021,37,168067,223569,3915277,3947060,24553,11.092,20148,9.102,491389,167514,323875,4.244,12.449,554180,146260,407920,3.706,14.040,-62791,-1.591,24.899,11446,11799,61021
2021,38,17594,22502,332353,342599,1941,8.650,1816,8.093,30026,10304,19722,3.008,8.764,50432,12168,38264,3.552,14.720,-20406,-5.956,17.528,1089,1122,6763
2021,39,165071,231234,4792411,4865190,20655,8.954,19555,8.477,558659,167672,390987,3.446,11.483,701090,177572,523518,3.650,14.410,-142431,-2.928,22.966,10718,11164,71309
2021,40,65996,86567,1355530,1381900,8484,9.844,7725,8.963,159707,56313,103394,4.075,11.557,211577,50837,160740,3.679,15.311,-51870,-3.754,23.114,4753,4922,25407
2021,41,85959,108256,1574023,1615485,10988,10.159,10794,9.980,180074,58169,121905,3.601,11.147,261687,65974,195713,4.084,16.199,-81613,-5.052,22.293,6565,6722,34939
2021,42,205854,277255,5257099,5394722,24456,8.780,27045,9.709,571601,205788,365813,3.815,10.596,846458,201277,645181,3.731,15.690,-274857,-5.095,21.191,14253,14850,80366
2021,44,21364,25673,412982,429165,2380,9.215,2688,10.408,37079,12670,24409,2.952,8.640,68882,16345,52537,3.809,16.050,-31803,-7.410,17.280,1409,1456,6986
2021,45,79716,106214,1821835,1845662,11420,10.884,8839,8.424,219292,82564,136728,4.473,11.881,267106,71293,195813,3.863,14.472,-47814,-2.591,23.763,5142,5364,29036
2021,46,20411,25240,364072,365049,2250,8.989,1829,7.307,38308,11744,26564,3.217,10.494,40320,10411,29909,2.852,11.045,-2012,-0.551,20.988,1182,1206,5679
2021,47,94549,133813,2723279,2746333,13885,10.473,11413,8.609,350001,126090,223911,4.591,12.744,393075,97825,295250,3.562,14.313,-43074,-1.568,25.489,6358,6761,43371
2021,48,423884,576403,10839032,11035931,67551,11.851,54730,9.602,1355410,519682,835728,4.709,12.282,1748399,424789,1323610,3.849,15.843,-392989,-3.561,24.564,32759,34123,208447
2021,49,63978,77776,1449441,1428184,10720,14.130,6906,9.103,216650,66726,149924,4.672,15.170,174623,46509,128114,3.257,12.227,42027,2.943,24.454,4339,4395,27439
2021,50,15323,18360,239440,248598,1556,8.410,1840,9.945,23428,8303,15125,3.340,9.424,41716,8436,33280,3.393,16.781,-18288,-7.356,18.848,1049,1081,4352
2021,51,140614,187382,3359558,3423224,18768,10.032,18173,9.714,403879,129912,273967,3.795,11.798,531610,134883,396727,3.940,15.530,-127731,-3.731,23.596,9750,10089,50748
2021,53,139124,174990,2749379,2811407,19707,11.315,18060,10.369,335743,119810,215933,4.262,11.942,457644,115092,342552,4.094,16.278,-121901,-4.336,23.884,10712,10997,52951
2021,54,23145,32902,520891,533538,2621,7.932,2904,8.788,53307,19620,33687,3.677,9.991,78415,21226,57189,3.978,14.697,-25108,-4.706,19.982,1637,1700,9783
2021,55,96988,130196,2523640,2561428,10825,8.319,10666,8.197,266254,80776,185478,3.154,10.395,341328,77439,263889,3.023,13.326,-75074,-2.931,20.790,6100,6306,35851
2021,56,16517,19505,199533,204474,2320,12.044,1835,9.526,24050,10147,13903,4.962,11.762,34109,9352,24757,4.574,16.681,-10059,-4.919,23.524,1151,1176,4735
2022,01,70912,97218,1775303,1749231,9563,9.906,8211,8.505,253994,64618,189376,3.694,14.520,201551,66803,134748,3.819,11.522,52443,2.998,23.045,5041,5242,29960
2022,02,14667,18583,257037,253544,2028,10.972,1829,9.895,40750,9655,31095,3.808,16.072,34135,12823,21312,5.058,13.463,6615,2.609,26.926,1112,1127,7000
2022,04,105880,139826,2799775,2709141,17658,12.805,13800,10.007,496609,136428,360181,5.036,18.331,317230,116262,200968,4.291,11.710,179379,6.621,23.419,8968,9117,54835
2022,05,47291,63552,1097164,1068262,6196,9.794,5615,8.876,177167,52011,125156,4.869,16.585,119603,39393,80210,3.688,11.196,57564,5.389,22.392,3520,3665,18375
2022,06,718289,893219,15662458,15078253,120328,13.734,86207,9.839,2889774,762030,2127744,5.054,19.165,1717255,649215,1068040,4.306,11.389,1172519,7.776,22.778,57969,59046,299969
2022,08,127773,158345,2484930,2419548,19840,12.621,17536,11.156,435004,135328,299676,5.593,17.979,303697,111961,191736,4.627,12.552,131307,5.427,25.104,11707,11889,58260
2022,09,63214,81214,1512177,1479100,8043,9.967,7004,8.680,213187,57064,156123,3.858,14.413,146886,48467,98419,3.277,9.931,66301,4.483,19.862,4396,4492,21833
2022,10,20235,25085,433098,422684,3173,12.808,2551,10.297,74728,24785,49943,5.864,17.679,53660,25053,28607,5.927,12.695,21068,4.984,25.390,1622,1677,14421
2022,11,17307,22015,536764,512945,2442,11.149,2218,10.126,95537,21414,74123,4.175,18.625,48332,19741,28591,3.849,9.422,47205,9.203,18.845,1112,1134,6988
2022,12,445440,553332,8821881,8561030,76030,13.927,61219,11.214,1524871,454414,1070457,5.308,17.812,1001975,381614,620361,4.458,11.704,522896,6.108,23.408,43114,43860,219414
2022,13,175445,228703,4231526,4125261,28509,12.580,24358,10.748,693711,195433,498278,4.737,16.816,481413,177849,303564,4.311,11.670,212298,5.146,23.340,16577,16894,91003
2022,15,22986,29941,506781,488390,3354,11.354,2554,8.646,83424,17149,66275,3.511,17.081,46971,14582,32389,2.986,9.618,36453,7.464,19.235,1532,1557,6768
2022,16,40926,49520,693619,673259,6581,13.545,4715,9.704,113343,35811,77532,5.319,16.835,72652,24425,48227,3.628,10.791,40691,6.044,21.582,3171,3207,14590
2022,17,222586,285473,5506697,5376081,30272,10.668,26877,9.471,869493,235519,633974,4.381,16.173,604731,221994,382737,4.129,11.249,264762,4.925,22.497,16841,17257,95263
2022,18,101669,140415,2884765,2823566,13548,9.714,11659,8.359,427511,109286,318225,3.870,15.141,305048,94196,210852,3.336,10.804,122463,4.337,21.607,6971,7258,46191
2022,19,56530,75683,1386816,1368670,6498,8.588,6457,8.534,181765,49047,132718,3.584,13.280,144825,45168,99657,3.300,10.581,36940,2.699,21.163,3889,4064,19397
2022,20,52470,69496,1231835,1216332,6380,9.210,5928,8.558,172251,44490,127761,3.658,14.162,140738,39839,100899,3.275,11.571,31513,2.591,23.141,3694,3783,19981
2022,21,61296,85788,1663101,1639894,8275,9.710,7140,8.378,240350,65109,175241,3.970,14.656,195420,58755,136665,3.583,11.917,44930,2.740,23.833,4275,4431,26294
2022,22,74791,99125,1639340,1614994,9523,9.637,8914,9.020,237063,64158,172905,3.973,14.679,187885,61797,126088,3.826,11.634,49178,3.045,23.268,5643,5838,33013
2022,23,30471,38002,532241,519048,4012,10.656,3305,8.779,81713,21245,60468,4.093,15.743,55108,19168,35940,3.693,10.617,26605,5.126,21.234,2134,2166,9684
2022,24,100104,128459,2395449,2337513,13831,10.842,12062,9.455,379873,118526,261347,5.071,16.251,261985,98361,163624,4.208,11.208,117888,5.043,22.416,7421,7549,42494
2022,25,129866,164683,3391862,3284915,17841,10.967,13829,8.501,537775,133604,404171,4.067,16.371,324783,116699,208084,3.553,9.887,212992,6.484,19.774,8722,8933,50563
2022,26,154206,203936,3907582,3830116,21370,10.570,17861,8.834,575395,139428,435967,3.640,15.023,420272,135980,284292,3.550,10.973,155123,4.050,21.946,10983,11339,66830
2022,27,103681,136114,2701069,2646326,13273,9.793,12109,8.934,393834,93152,300682,3.520,14.882,283793,96437,187356,3.644,10.724,110041,4.158,21.448,7596,7817,43652
2022,28,41254,55935,941877,937208,5293,9.496,4903,8.796,123887,34523,89364,3.684,13.219,114150,32977,81173,3.519,12.180,9737,1.039,24.360,3164,3275,16552
2022,29,104621,139770,2563152,2516811,14423,10.359,13354,9.591,379256,103410,275846,4.109,15.069,286965,86300,200665,3.429,11.402,92291,3.667,22.804,8703,8939,43568
2022,30,30309,36008,398845,389796,4206,11.816,3383,9.504,63185,21353,41832,5.478,16.210,45100,14764,30336,3.788,11.570,18085,4.640,23.140,2285,2327,8674
2022,31,39873,50893,893995,872623,4568,9.010,4180,8.245,136157,28581,107576,3.275,15.603,93810,30018,63792,3.440,10.750,42347,4.853,21.501,2645,2689,13772
2022,32,52610,67016,1291230,1228377,9438,14.375,6715,10.228,253017,64765,188252,5.272,20.598,127807,45117,82690,3.673,10.405,125210,10.193,20.809,4508,4610,24326
2022,33,28548,35863,614868,600341,3594,10.106,2997,8.427,89601,21585,68016,3.595,14.925,60375,19792,40583,3.297,10.057,29226,4.868,20.114,1861,1919,10536
2022,34,173772,212026,3821848,3696467,25272,12.065,20155,9.622,626434,158274,468160,4.282,16.947,373234,137780,235454,3.727,10.097,253200,6.850,20.194,13394,13719,72643
2022,35,31159,40492,642864,624651,4400,10.958,3723,9.272,104408,25916,78492,4.149,16.715,67969,25162,42807,4.028,10.881,36439,5.833,21.762,2268,2313,11290
2022,36,398971,477257,8285936,8010520,58427,12.400,46318,9.830,1375697,355739,1019958,4.441,17.174,820076,299762,520314,3.742,10.237,555621,6.936,20.475,31582,32171,166930
2022,37,173080,229327,4102817,4009559,26299,11.615,20490,9.049,631726,180890,450836,4.511,15.755,444894,144211,300683,3.597,11.096,186832,4.660,22.192,13272,13540,67672
2022,38,17717,22634,344240,338303,2061,9.133,1925,8.531,48320,12387,35933,3.662,14.283,36368,11680,24688,3.453,10.750,11952,3.533,21.500,1156,1209,6325
2022,39,167160,233168,4916838,4843721,21707,9.349,19739,8.501,745356,201017,544339,4.150,15.388,593852,202945,390907,4.190,12.260,151504,3.128,24.520,11769,12142,72139
2022,40,66480,86955,1395480,1374460,8701,10.032,8264,9.528,203556,55471,148085,4.036,14.810,162441,55715,106726,4.054,11.819,41115,2.991,23.637,5290,5480,29539
2022,41,88251,110605,1660922,1616941,12584,11.501,10201,9.323,277245,79086,198159,4.891,17.146,188122,65133,122989,4.028,11.634,89123,5.512,23.269,6713,6858,32086
2022,42,210907,282450,5594746,5442316,27736,9.911,22532,8.052,829522,210201,619321,3.862,15.242,522329,177111,345218,3.254,9.598,307193,5.645,19.195,13735,14114,76363
2022,44,22141,26504,439106,426089,3019,11.574,2180,8.357,65235,17064,48171,4.005,15.310,39373,12694,26679,2.979,9.241,25862,6.070,18.481,1408,1421,7255
2022,45,82126,109004,1904980,1864907,12120,11.263,9326,8.667,296769,87355,209414,4.684,15.913,217189,73750,143439,3.955,11.646,79580,4.267,23.292,5890,5985,31148
2022,46,20851,25796,373461,368113,2535,9.936,1970,7.721,49981,14352,35629,3.899,13.578,39050,11647,27403,3.164,10.608,10931,2.969,21.216,1320,1343,5716
2022,47,96419,135921,2857048,2791181,14323,10.620,12205,9.050,440854,129960,310894,4.656,15.795,307274,97202,210072,3.482,11.009,133580,4.786,22.017,7576,7914,50184
2022,48,438100,592192,11543459,11194504,72925,12.482,57006,9.757,1971870,585758,1386112,5.233,17.615,1270582,459333,811249,4.103,11.350,701288,6.265,22.700,37344,38354,228375
2022,49,66282,80406,1522510,1486130,10912,13.798,8266,10.452,249432,79050,170382,5.319,16.784,176502,63739,112763,4.289,11.877,72930,4.907,23.753,5566,5652,33931
2022,50,15760,18727,253084,246197,1982,10.691,1607,8.668,36814,8288,28526,3.366,14.953,23049,8587,14462,3.488,9.362,13765,5.591,18.724,953,976,4567
2022,51,143142,189635,3493659,3426503,20289,10.764,18012,9.556,519386,137974,381412,4.027,15.158,383823,136152,247671,3.973,11.202,135563,3.956,22.403,10872,11116,57242
2022,53,142271,178138,2885244,2816221,21320,12.076,18130,10.269,474359,133418,340941,4.737,16.844,336337,116250,220087,4.128,11.943,138022,4.901,23.886,11828,12038,53683
2022,54,23447,33083,541234,531479,3032,9.191,2845,8.624,75120,23559,51561,4.433,14.134,55910,18422,37488,3.466,10.520,19210,3.614,21.039,1527,1578,7817
2022,55,98004,131180,2598495,2560833,11805,9.034,10791,8.258,360763,92336,268427,3.606,14.088,285090,85983,199107,3.358,11.133,75673,2.955,22.265,6465,6734,38631
2022,56,16887,19937,207929,203815,2491,12.634,2050,10.397,34208,12417,21791,6.092,16.784,25723,10312,15411,5.059,12.621,8485,4.163,25.242,1406,1426,6607
2023,01,71429,98246,1818849,1797128,9094,9.306,8044,8.232,223092,66526,156566,3.702,12.414,179480,56339,123141,3.135,9.987,43612,2.427,19.974,5927,6079,34677
2023,02,14857,18870,265960,261486,2000,10.681,1708,9.122,37232,8828,28404,3.376,14.239,28189,7437,20752,2.844,10.780,9043,3.458,21.561,1267,1285,4548
2023,04,107886,142865,2876740,2838312,17539,12.409,14488,10.250,430147,151048,279099,5.322,15.155,353301,107501,245800,3.787,12.448,76846,2.707,24.895,10763,10990,63573
2023,05,47875,64549,1120115,1108275,6162,9.621,5157,8.052,130755,40552,90203,3.659,11.798,107677,29755,77922,2.685,9.716,23078,2.082,19.431,3921,3977,18605
2023,06,725847,903355,15907513,15792671,102404,11.401,92125,10.256,2130913,650492,1480421,4.119,13.493,1903480,597518,1305962,3.784,12.053,227433,1.440,24.106,71550,72607,365557
2023,08,127843,159307,2558812,2522774,18720,11.787,17744,11.172,383801,123940,259861,4.913,15.213,311631,111158,200473,4.406,12.353,72170,2.861,24.705,13463,13644,69266
2023,09,63314,81451,1536064,1524043,7142,8.782,6891,8.473,206722,51382,155340,3.371,13.564,182920,50388,132532,3.306,12.002,23802,1.562,24.005,4986,5058,25757
2023,10,20713,25549,457450,442035,3227,12.811,2506,9.949,78521,33214,45307,7.514,17.764,48491,17507,30984,3.961,10.970,30030,6.794,21.940,1867,1879,9833
2023,11,17380,22078,562058,549475,2012,9.125,1954,8.862,76841,17184,59657,3.127,13.984,52283,14597,37686,2.657,9.515,24558,4.469,19.030,1282,1292,7591
2023,12,455648,565546,9192420,9022732,73309,13.105,61024,10.909,1346948,432880,914068,4.798,14.928,1005516,346372,659144,3.839,11.144,341432,3.784,22.289,48092,48600,209594
2023,13,177543,232284,4323378,4269673,27181,11.793,23578,10.230,608013,194803,413210,4.562,14.240,497792,167119,330673,3.914,11.659,110221,2.581,23.318,18263,18493,95475
2023,15,23176,30055,520421,513424,2759,9.199,2635,8.785,62301,17557,44744,3.420,12.134,48200,16373,31827,3.189,9.388,14101,2.746,18.776,1927,1970,9980
2023,16,41589,50318,708872,701556,6017,12.055,5204,10.426,95377,32121,63256,4.579,13.595,80191,26062,54129,3.715,11.430,15186,2.165,22.861,3978,4038,17878
2023,17,222365,286518,5603001,5540467,27241,9.526,26123,9.135,716207,208387,507820,3.761,12.927,593050,186229,406821,3.361,10.704,123157,2.223,21.408,19266,19461,91664
2023,18,102872,142793,2921474,2902180,14333,10.123,11927,8.424,357969,116206,241763,4.004,12.334,319415,90690,228725,3.125,11.006,38554,1.328,22.012,8131,8301,43229
2023,19,56436,75787,1428399,1408128,6491,8.572,6371,8.413,180546,62051,118495,4.407,12.822,141348,43312,98036,3.076,10.038,39198,2.784,20.076,4456,4579,22753
2023,20,52865,70039,1250703,1241265,6400,9.177,5807,8.326,157784,47096,110688,3.794,12.712,138178,43622,94556,3.514,11.132,19606,1.580,22.264,4157,4212,22344
2023,21,61917,86735,1698365,1681001,8084,9.375,7073,8.203,209367,61987,147380,3.688,12.455,173482,57675,115807,3.431,10.320,35885,2.135,20.640,4816,4935,26232
2023,22,75251,99981,1691269,1664754,8893,8.934,8019,8.056,220199,61673,158526,3.705,13.227,167430,47443,119987,2.850,10.057,52769,3.170,20.115,6054,6164,29565
2023,23,30735,38288,547777,539937,3591,9.416,3289,8.624,68600,19780,48820,3.663,12.705,52881,15826,37055,2.931,9.794,15719,2.911,19.588,2438,2481,10412
2023,24,100768,129266,2416972,2406595,12571,9.756,11758,9.125,298589,82350,216239,3.422,12.407,279572,79778,199794,3.315,11.617,19017,0.790,23.234,8460,8604,46191
2023,25,131145,166592,3479771,3435647,15906,9.603,13982,8.442,425615,122772,302843,3.573,12.388,338415,95983,242432,2.794,9.850,87200,2.538,19.700,10263,10380,49917
2023,26,155861,206581,3973169,3929395,20012,9.751,17296,8.428,511583,158740,352843,4.040,13.019,425198,122574,302624,3.119,10.821,86385,2.198,21.642,12495,12751,70710
2023,27,103804,136484,2754895,2727879,12111,8.887,11710,8.592,330201,83867,246334,3.074,12.105,274953,80482,194471,2.950,10.079,55248,2.025,20.159,8407,8558,44342
2023,28,41438,56227,954354,947649,5090,9.077,4791,8.544,115877,37118,78759,3.917,12.228,102042,28729,73313,3.032,10.768,13835,1.460,21.536,3526,3649,17002
2023,29,102345,138037,2629760,2596357,13817,10.032,13188,9.576,339222,99298,239924,3.825,13.065,272283,82388,189895,3.173,10.487,66939,2.578,20.974,9796,9984,46508
2023,30,30773,36621,408516,403847,4143,11.410,3524,9.705,53883,20514,33369,5.080,13.342,44597,15699,28898,3.887,11.043,9286,2.299,22.086,2698,2732,11347
2023,31,40134,51269,920840,906175,4573,8.953,4196,8.214,118217,34199,84018,3.774,13.046,88436,25530,62906,2.817,9.759,29781,3.286,19.519,3103,3155,16261
2023,32,53623,68195,1336937,1313887,8474,12.537,7271,10.757,200067,56798,143269,4.323,15.227,154193,54805,99388,4.171,11.736,45874,3.491,23.471,5502,5557,29997
2023,33,28617,35957,625841,620715,3157,8.792,3060,8.522,68575,18714,49861,3.015,11.048,58294,18414,39880,2.967,9.391,10281,1.656,18.783,2297,2333,12203
2023,34,175347,213967,3915778,3869974,22378,10.507,20403,9.580,525685,160264,365421,4.141,13.584,433606,128880,304726,3.330,11.204,92079,2.379,22.409,15633,15818,75887
2023,35,31579,40902,655486,650009,4180,10.272,3762,9.245,82538,25836,56702,3.975,12.698,71521,22683,48838,3.490,11.003,11017,1.695,22.006,2679,2727,13901
2023,36,402077,481232,8517882,8376156,50464,10.530,46442,9.691,1171132,331416,839716,3.957,13.982,891326,282161,609165,3.369,10.641,279806,3.341,21.282,36499,36833,171509
2023,37,175992,233077,4256925,4191283,24761,10.711,20975,9.073,569576,169585,399991,4.046,13.590,436572,136204,300368,3.250,10.416,133004,3.173,20.832,15671,15949,77147
2023,38,17941,22921,350598,347484,2107,9.251,1819,7.986,43780,13986,29794,4.025,12.599,37595,11441,26154,3.293,10.819,6185,1.780,21.638,1322,1350,6649
2023,39,167526,234409,5027851,4969991,20354,8.707,19055,8.152,648248,174538,473710,3.512,13.043,531582,156534,375048,3.150,10.696,116666,2.347,21.392,13461,13753,81497
2023,40,66967,87916,1426226,1411436,8785,10.049,7796,8.918,182150,53712,128438,3.805,12.905,152305,51610,100695,3.657,10.791,29845,2.115,21.582,5883,5985,33135
2023,41,88326,111067,1689913,1676018,11365,10.255,10883,9.820,222380,66207,156173,3.950,13.268,196710,67566,129144,4.031,11.737,25670,1.532,23.473,8259,8387,36429
2023,42,211009,282707,5681241,5621671,23346,8.262,23053,8.159,679057,188942,490115,3.361,12.079,562881,178764,384117,3.180,10.013,116176,2.067,20.025,16423,16726,86158
2023,44,22225,26622,443646,441327,2465,9.283,2330,8.774,51150,12566,38584,2.847,11.590,46374,13919,32455,3.154,10.508,4776,1.082,21.016,1772,1790,8019
2023,45,83764,111317,1951355,1928105,11778,10.692,9451,8.580,259166,83790,175376,4.346,13.441,211497,65495,146002,3.397,10.969,47669,2.472,21.938,7101,7168,37377
2023,46,21106,26095,385660,379962,2473,9.533,2167,8.353,49489,15091,34398,3.972,13.025,38028,11556,26472,3.041,10.008,11461,3.016,20.017,1601,1625,7199
2023,47,97956,138491,2925437,2874921,14562,10.614,11966,8.722,423105,143921,279184,5.006,14.717,321624,98539,223085,3.428,11.187,101481,3.530,22.374,8542,8709,57380
2023,48,448396,606811,11984314,11762236,71036,11.850,56311,9.394,1792537,577349,1215188,4.908,15.240,1343815,421646,922169,3.585,11.425,448722,3.815,22.850,42636,43453,237819
2023,49,67722,82240,1574157,1548745,10379,12.766,8508,10.464,225800,71897,153903,4.642,14.580,174515,51153,123362,3.303,11.268,51285,3.311,22.536,6582,6670,32786
2023,50,15868,18786,255565,254353,1677,8.944,1607,8.570,27674,7257,20417,2.853,10.880,25114,8680,16434,3.413,9.874,2560,1.006,19.747,1182,1209,5329
2023,51,144508,191642,3570146,3528899,19099,10.019,17058,8.949,471983,125301,346682,3.551,13.375,388560,123748,264812,3.507,11.011,83423,2.364,22.022,12402,12630,66576
2023,53,142661,179034,2959530,2926672,19378,10.852,18452,10.333,427367,137323,290044,4.692,14.602,361099,130673,230426,4.465,12.338,66268,2.264,24.676,13915,14127,66959
2023,54,23492,33360,550549,545560,3045,9.167,2761,8.312,67586,19758,47828,3.622,12.388,57640,19361,38279,3.549,10.565,9946,1.823,21.131,1823,1857,10632
2023,55,98413,132123,2636330,2618785,11640,8.843,10656,8.095,315849,98945,216904,3.778,12.061,280288,76948,203340,2.938,10.703,35561,1.358,21.406,7639,7757,44493
2023,56,17326,20421,213160,210519,2570,12.737,2082,10.319,30712,11402,19310,5.416,14.589,25283,9347,15936,4.440,12.010,5429,2.579,24.020,1576,1585,6521
